trial_len1,trial_len2,reach_diff,peak_velRight,peak_velLeft,vel_inxR,vel_inxL,mo_timeR,mo_timeL,Filename,Participant,Load,Distance,Difficulty,TrialNo,Load_kind,index_diff
892,1919,1027,1.117778139,1.458175561,632,619,1,1,'01_01_01.c3d',1,EE,B,E,1,Same,13
789,1399,610,0.843783301,1.269257503,450,537,123,92,'01_01_02.c3d',1,EE,B,E,2,Same,87
1084,1228,144,1.001019743,1.218951903,514,547,160,278,'01_01_03.c3d',1,EE,B,E,3,Same,33
907,1046,139,1.16810262,1.016273905,546,521,166,22,'01_01_04.c3d',1,EE,B,E,4,Same,25
920,1016,96,1.017739634,1.085013422,643,863,115,154,'01_01_05.c3d',1,EE,B,E,5,Same,220
1422,2500,1078,0.78914443,1.11970679,538,504,239,62,'01_01_01.c3d',2,EE,B,E,1,Same,34
1320,1613,293,0.94888641,1.18815003,550,494,298,234,'01_01_02.c3d',2,EE,B,E,2,Same,56
1156,1418,262,1.13554443,1.30687578,591,589,347,314,'01_01_03.c3d',2,EE,B,E,3,Same,2
1406,1991,585,0.91798989,1.24551508,475,926,6,1,'01_01_04.c3d',2,EE,B,E,4,Same,451
1916,2129,213,0.94103284,1.09525322,609,571,60,1,'01_01_05.c3d',2,EE,B,E,5,Same,38
698,705,7,2.259939137,2.358944088,435,434,11,1,'01_01_01.c3d',3,EE,B,E,1,Same,1
542,1705,1163,2.089468375,2.070642029,438,411,141,1,'01_01_02.c3d',3,EE,B,E,2,Same,27
1119,1155,36,1.65942854,2.065874313,838,809,630,79,'01_01_03.c3d',3,EE,B,E,3,Same,29
799,929,130,1.346928883,1.591302017,439,429,57,1,'01_01_04.c3d',3,EE,B,E,4,Same,10
735,787,52,1.710915437,2.015252263,551,572,281,1,'01_01_05.c3d',3,EE,B,E,5,Same,21
1150,1321,171,1.265207755,1.227177614,653,642,84,430,'01_01_01.c3d',4,EE,B,E,1,Same,11
1153,1505,352,1.739596826,1.522205296,831,841,586,180,'01_01_02.c3d',4,EE,B,E,2,Same,10
1197,1505,308,1.953076766,2.119636784,563,574,1,352,'01_01_03.c3d',4,EE,B,E,3,Same,11
916,1128,212,2.154101343,2.597399292,621,630,1,420,'01_01_04.c3d',4,EE,B,E,4,Same,9
738,958,220,1.442623921,1.350682338,466,470,239,199,'01_01_05.c3d',4,EE,B,E,5,Same,4
788,867,79,2.781110191,2.556565335,441,457,279,264,'01_01_01.c3d',5,EE,B,E,1,Same,16
549,1002,453,2.376631294,2.327993259,386,378,123,199,'01_01_02.c3d',5,EE,B,E,2,Same,8
640,845,205,1.745656914,2.19126209,481,437,1,1,'01_01_03.c3d',5,EE,B,E,3,Same,44
701,758,57,2.144769979,2.228016252,389,414,259,264,'01_01_04.c3d',5,EE,B,E,4,Same,25
678,691,13,2.426472194,2.723151469,375,400,172,131,'01_01_05.c3d',5,EE,B,E,5,Same,25
1123,1902,779,1.000396896,2.027753501,1409,667,421,83,'01_01_01.c3d',6,EE,B,E,1,Same,742
1207,1532,325,1.024636232,1.381478261,648,685,1,1,'01_01_02.c3d',6,EE,B,E,2,Same,37
803,894,91,1.428822873,1.507432776,703,735,285,281,'01_01_03.c3d',6,EE,B,E,3,Same,32
788,1174,386,1.53776592,1.694107349,679,576,210,1,'01_01_04.c3d',6,EE,B,E,4,Same,103
964,1020,56,1.529360848,1.46147743,596,544,18,1,'01_01_05.c3d',6,EE,B,E,5,Same,52
1011,1070,59,1.514882882,1.462231056,572,573,1,353,'01_01_01.c3d',7,EE,B,E,1,Same,1
1129,1158,29,1.380151195,1.529741217,597,647,332,372,'01_01_02.c3d',7,EE,B,E,2,Same,50
826,913,87,1.69120416,1.550672087,503,526,270,258,'01_01_03.c3d',7,EE,B,E,3,Same,23
1194,1596,402,1.221625858,1.119274014,439,431,1,44,'01_01_04.c3d',7,EE,B,E,4,Same,8
1018,1052,34,1.448433797,1.623900078,527,523,299,302,'01_01_05.c3d',7,EE,B,E,5,Same,4
1086,1095,9,1.593343884,1.518374067,574,589,1,331,'01_01_01.c3d',8,EE,B,E,1,Same,15
1077,2503,1426,1.08362866,1.389898255,473,517,256,267,'01_01_02.c3d',8,EE,B,E,2,Same,44
1413,2645,1232,0.71274135,0.975471351,466,470,231,226,'01_01_03.c3d',8,EE,B,E,3,Same,4
1033,1285,252,1.033210267,1.113154859,451,495,171,141,'01_01_04.c3d',8,EE,B,E,4,Same,44
1195,2160,965,0.933185267,0.929135263,407,403,1,106,'01_01_05.c3d',8,EE,B,E,5,Same,4
911,1950,1039,0.984698497,2.177711065,553,514,1,339,'01_01_01.c3d',9,EE,B,E,1,Same,39
948,1945,997,1.433133745,1.320023081,454,441,246,203,'01_01_02.c3d',9,EE,B,E,2,Same,13
770,1077,307,1.194738652,1.549767236,442,438,1,1,'01_01_03.c3d',9,EE,B,E,3,Same,4
1186,1628,442,1.339105596,1.587266574,590,564,365,357,'01_01_04.c3d',9,EE,B,E,4,Same,26
1141,1585,444,1.564418411,1.476413347,544,496,94,288,'01_01_05.c3d',9,EE,B,E,5,Same,48
777,1163,386,2.844776668,3.467922921,562,534,360,347,'01_01_01.c3d',10,EE,B,E,1,Same,28
1066,1115,49,1.704112181,1.852856866,528,504,33,282,'01_01_02.c3d',10,EE,B,E,2,Same,24
1178,1234,56,1.513223103,1.962366383,528,483,275,246,'01_01_03.c3d',10,EE,B,E,3,Same,45
1414,1512,98,1.394776701,1.814199008,533,532,320,323,'01_01_04.c3d',10,EE,B,E,4,Same,1
924,1036,112,1.706681276,2.673295367,524,522,343,345,'01_01_05.c3d',10,EE,B,E,5,Same,2
1361,2359,998,0.76497027,1.00696833,742,799,365,1,'01_01_01.c3d',11,EE,B,E,1,Same,57
1722,1736,14,0.56242408,0.5653678,1234,1175,220,224,'01_01_02.c3d',11,EE,B,E,2,Same,59
1724,3063,1339,0.68152126,0.74140909,786,804,71,1,'01_01_03.c3d',11,EE,B,E,3,Same,18
1749,2206,457,0.74504094,0.75311406,1195,1215,1,13,'01_01_04.c3d',11,EE,B,E,4,Same,20
1381,1693,312,0.86396649,0.86665497,1174,1256,45,420,'01_01_05.c3d',11,EE,B,E,5,Same,82
959,1047,88,1.208894623,1.538912173,544,539,1,339,'01_01_01.c3d',12,EE,B,E,1,Same,5
931,1034,103,1.491097268,1.314191904,547,560,349,317,'01_01_02.c3d',12,EE,B,E,2,Same,13
849,954,105,1.590311323,1.373806395,493,529,300,303,'01_01_03.c3d',12,EE,B,E,3,Same,36
850,981,131,1.668771863,1.504457026,509,528,276,54,'01_01_04.c3d',12,EE,B,E,4,Same,19
895,1143,248,1.500792595,1.488863284,493,550,298,1,'01_01_05.c3d',12,EE,B,E,5,Same,57
1090,1614,524,1.739708445,1.579737645,574,607,52,1,'01_01_01.c3d',13,EE,B,E,1,Same,33
992,998,6,1.852135267,1.737927562,559,583,93,1,'01_01_02.c3d',13,EE,B,E,2,Same,24
1005,1216,211,1.435325281,1.85789818,537,564,271,302,'01_01_03.c3d',13,EE,B,E,3,Same,27
766,1317,551,1.515668703,1.871466776,479,483,265,278,'01_01_04.c3d',13,EE,B,E,4,Same,4
1015,1025,10,1.345927019,1.597380861,543,535,51,340,'01_01_05.c3d',13,EE,B,E,5,Same,8
665,1224,559,2.374843916,2.900389369,436,443,246,233,'01_01_01.c3d',14,EE,B,E,1,Same,7
683,879,196,2.198581456,2.712625174,409,439,218,232,'01_01_02.c3d',14,EE,B,E,2,Same,30
757,791,34,1.766513121,1.878051723,417,477,185,211,'01_01_03.c3d',14,EE,B,E,3,Same,60
697,1668,971,1.625986707,2.082345976,418,520,1,49,'01_01_04.c3d',14,EE,B,E,4,Same,102
885,945,60,1.864850674,1.808940791,437,472,223,239,'01_01_05.c3d',14,EE,B,E,5,Same,35
921,978,57,1.53325832,1.931175753,588,699,223,359,'01_01_01.c3d',15,EE,B,E,1,Same,111
826,1011,185,1.828368319,2.446269427,463,554,261,266,'01_01_02.c3d',15,EE,B,E,2,Same,91
788,1248,460,1.699976528,2.4245251,502,530,303,277,'01_01_03.c3d',15,EE,B,E,3,Same,28
781,2017,1236,1.305148707,1.77454186,372,590,112,15,'01_01_04.c3d',15,EE,B,E,4,Same,218
741,799,58,1.559287941,1.669053834,459,482,136,75,'01_01_05.c3d',15,EE,B,E,5,Same,23
1197,1585,388,1.035257373,1.975322577,590,691,45,1,'01_01_01.c3d',16,EE,B,E,1,Same,101
785,786,1,1.816430431,2.178835718,514,546,298,289,'01_01_02.c3d',16,EE,B,E,2,Same,32
1350,1606,256,1.023065031,1.315097146,351,633,118,88,'01_01_03.c3d',16,EE,B,E,3,Same,282
766,1010,244,1.655182711,2.124757547,453,452,1,73,'01_01_04.c3d',16,EE,B,E,4,Same,1
733,835,102,1.743175427,1.856467151,534,432,184,196,'01_01_05.c3d',16,EE,B,E,5,Same,102
633,833,200,4.086465459,3.521978765,424,432,295,298,'01_01_01.c3d',17,EE,B,E,1,Same,8
562,797,235,3.521608287,3.439856551,359,360,236,227,'01_01_02.c3d',17,EE,B,E,2,Same,1
653,764,111,2.957219793,3.035234055,393,407,255,258,'01_01_03.c3d',17,EE,B,E,3,Same,14
616,836,220,3.074332171,3.632929371,432,434,302,308,'01_01_04.c3d',17,EE,B,E,4,Same,2
663,702,39,2.925243116,2.403779266,431,482,274,273,'01_01_05.c3d',17,EE,B,E,5,Same,51
764,964,200,2.084898845,2.525333756,474,512,67,1,'01_01_01.c3d',18,EE,B,E,1,Same,38
946,1578,632,2.44938661,2.125798796,474,493,14,136,'01_01_02.c3d',18,EE,B,E,2,Same,19
746,998,252,1.848148295,2.310444113,447,456,266,25,'01_01_03.c3d',18,EE,B,E,3,Same,9
741,825,84,2.281052025,2.377720227,462,486,286,274,'01_01_04.c3d',18,EE,B,E,4,Same,24
702,721,19,1.889318862,1.63185741,501,510,1,1,'01_01_05.c3d',18,EE,B,E,5,Same,9
773,937,164,1.712149,1.77631915,503,481,1,272,'01_01_01.c3d',19,EE,B,E,1,Same,22
828,993,165,1.52029073,1.54422737,574,546,340,1,'01_01_02.c3d',19,EE,B,E,2,Same,28
766,1092,326,1.32775378,1.4756431,471,495,257,252,'01_01_03.c3d',19,EE,B,E,3,Same,24
881,970,89,1.38347246,1.58660755,534,523,263,288,'01_01_04.c3d',19,EE,B,E,4,Same,11
928,1084,156,1.13491606,1.30742837,532,438,1,1,'01_01_05.c3d',19,EE,B,E,5,Same,94
990,1224,234,1.674747037,2.045155448,466,488,290,281,'01_01_01.c3d',20,EE,B,E,1,Same,22
1015,1365,350,1.855077058,2.008321445,537,552,350,335,'01_01_02.c3d',20,EE,B,E,2,Same,15
1169,1191,22,1.595231744,1.465863899,665,636,1,303,'01_01_03.c3d',20,EE,B,E,3,Same,29
1071,1650,579,1.42562201,1.669524832,557,611,82,93,'01_01_04.c3d',20,EE,B,E,4,Same,54
1035,1147,112,1.745438819,1.695632759,550,536,65,334,'01_01_05.c3d',20,EE,B,E,5,Same,14
994,1042,48,1.523700488,1.505814171,612,639,420,80,'01_01_01.c3d',21,EE,B,E,1,Same,27
1075,1402,327,1.208499714,1.331943805,535,568,316,1,'01_01_02.c3d',21,EE,B,E,2,Same,33
934,1249,315,1.023509319,1.014027695,817,799,235,171,'01_01_03.c3d',21,EE,B,E,3,Same,18
756,1146,390,1.089728117,0.872342257,628,187,1,1,'01_01_04.c3d',21,EE,B,E,4,Same,441
1128,1253,125,1.194622022,1.135255806,508,531,313,302,'01_01_05.c3d',21,EE,B,E,5,Same,23
1297,1454,157,0.963312736,1.300249813,596,584,295,344,'01_01_01.c3d',22,EE,B,E,1,Same,12
1621,2082,461,0.695878299,1.072038438,1062,1071,1,22,'01_01_02.c3d',22,EE,B,E,2,Same,9
1421,1535,114,0.813243394,1.387514449,806,865,328,410,'01_01_03.c3d',22,EE,B,E,3,Same,59
1526,1546,20,0.978409985,1.068170324,1027,1063,389,1,'01_01_04.c3d',22,EE,B,E,4,Same,36
1545,2046,501,0.896837866,1.409010796,871,873,296,350,'01_01_05.c3d',22,EE,B,E,5,Same,2
2408,3315,907,0.881069755,0.919655091,539,991,311,263,'01_01_01.c3d',23,EE,B,E,1,Same,452
2433,7399,4966,1.044264716,0.853873774,5649,610,296,321,'01_01_02.c3d',23,EE,B,E,2,Same,5039
4528,4593,65,0.628537509,0.74059141,1141,1049,31,263,'01_01_03.c3d',23,EE,B,E,3,Same,92
4040,5148,1108,0.343918672,0.406658529,1978,2248,1,356,'01_01_04.c3d',23,EE,B,E,4,Same,270
3573,4070,497,0.617714576,0.805993413,2368,1073,332,13,'01_01_05.c3d',23,EE,B,E,5,Same,1295
1054,1574,520,1.51996311,1.388743904,610,632,20,405,'01_01_01.c3d',24,EE,B,E,1,Same,22
947,972,25,1.735026294,1.690715703,551,547,311,82,'01_01_02.c3d',24,EE,B,E,2,Same,4
982,1085,103,1.336707476,1.568116994,506,508,279,292,'01_01_03.c3d',24,EE,B,E,3,Same,2
969,1179,210,1.007371512,1.096856122,559,528,1,1,'01_01_04.c3d',24,EE,B,E,4,Same,31
993,1508,515,1.133709768,1.44222191,430,456,128,1,'01_01_05.c3d',24,EE,B,E,5,Same,26
983,1043,60,1.416159791,1.328556197,487,515,244,253,'01_01_01.c3d',25,EE,B,E,1,Same,28
1329,1956,627,0.890446697,0.817466954,793,785,465,440,'01_01_02.c3d',25,EE,B,E,2,Same,8
882,1002,120,1.419687117,1.325761498,467,451,221,241,'01_01_03.c3d',25,EE,B,E,3,Same,16
1042,1495,453,1.048424999,1.052952181,555,590,245,275,'01_01_04.c3d',25,EE,B,E,4,Same,35
1297,1320,23,1.172315459,1.090505097,550,499,1,248,'01_01_05.c3d',25,EE,B,E,5,Same,51
1258,1719,461,0.948038556,1.301538282,537,517,307,290,'01_01_01.c3d',26,EE,B,E,1,Same,20
2057,2128,71,1.050071032,2.177371289,838,801,4,617,'01_01_02.c3d',26,EE,B,E,2,Same,37
1817,1903,86,1.151074206,1.181284049,571,582,1,1,'01_01_03.c3d',26,EE,B,E,3,Same,11
1138,2817,1679,0.849174284,1.019049371,1014,503,283,251,'01_01_04.c3d',26,EE,B,E,4,Same,511
1149,1634,485,1.139060409,0.978109529,497,556,67,44,'01_01_05.c3d',26,EE,B,E,5,Same,59
1784,2275,491,1.042069326,1.162522393,910,861,598,573,'01_01_01.c3d',27,EE,B,E,1,Same,49
1356,1552,196,1.207388259,1.195659291,724,772,435,310,'01_01_02.c3d',27,EE,B,E,2,Same,48
1906,2415,509,0.771048982,1.028460034,895,901,572,563,'01_01_03.c3d',27,EE,B,E,3,Same,6
1524,2116,592,0.793050506,1.278978615,1010,1052,41,1,'01_01_04.c3d',27,EE,B,E,4,Same,42
1697,1873,176,0.978009059,1.556803964,1297,1195,55,992,'01_01_05.c3d',27,EE,B,E,5,Same,102
973,1568,595,1.24926967,0.91828012,515,923,281,253,'01_01_01.c3d',28,EE,B,E,1,Same,408
1211,1672,461,0.88458041,1.03161229,518,779,1,291,'01_01_02.c3d',28,EE,B,E,2,Same,261
1240,1713,473,1.01549122,0.84840968,954,965,273,73,'01_01_03.c3d',28,EE,B,E,3,Same,11
1546,1806,260,0.88479768,0.96143867,646,593,362,26,'01_01_04.c3d',28,EE,B,E,4,Same,53
1132,1636,504,1.14947341,1.04567004,925,598,91,344,'01_01_05.c3d',28,EE,B,E,5,Same,327
995,1051,56,1.730930019,2.202168594,544,546,361,361,'01_01_01.c3d',29,EE,B,E,1,Same,2
762,1025,263,1.800494511,2.078482156,489,475,292,280,'01_01_02.c3d',29,EE,B,E,2,Same,14
1002,1121,119,1.366521331,1.182297114,527,537,268,1,'01_01_03.c3d',29,EE,B,E,3,Same,10
1695,2421,726,1.274155188,1.626425808,1020,986,755,12,'01_01_04.c3d',29,EE,B,E,4,Same,34
909,1465,556,1.428206257,1.706741039,570,563,1,349,'01_01_05.c3d',29,EE,B,E,5,Same,7
919,1398,479,0.990403287,1.151356931,490,458,128,243,'01_01_01.c3d',30,EE,B,E,1,Same,32
1050,1204,154,1.260594348,1.376807075,516,474,256,95,'01_01_02.c3d',30,EE,B,E,2,Same,42
879,1504,625,0.952192542,0.901583122,625,442,45,80,'01_01_03.c3d',30,EE,B,E,3,Same,183
1041,1375,334,1.00161643,0.981404552,530,482,292,1,'01_01_04.c3d',30,EE,B,E,4,Same,48
1173,1275,102,0.846203575,0.828831296,515,459,240,201,'01_01_05.c3d',30,EE,B,E,5,Same,56
1038,1597,559,2.835988165,2.768505273,582,596,369,403,'01_01_01.c3d',31,EE,B,E,1,Same,14
850,955,105,2.004499264,1.989956679,537,526,320,307,'01_01_02.c3d',31,EE,B,E,2,Same,11
874,2092,1218,2.407787502,2.271472381,517,508,301,309,'01_01_03.c3d',31,EE,B,E,3,Same,9
937,982,45,2.103144246,2.058224454,557,515,315,299,'01_01_04.c3d',31,EE,B,E,4,Same,42
915,963,48,2.30452489,2.306188381,473,482,288,293,'01_01_05.c3d',31,EE,B,E,5,Same,9
918,1003,85,1.643562222,1.898242169,604,586,364,359,'01_01_01.c3d',32,EE,B,E,1,Same,18
941,1615,674,1.142534102,1.566611023,537,546,298,297,'01_01_02.c3d',32,EE,B,E,2,Same,9
963,1059,96,1.719860814,1.64131256,613,632,376,47,'01_01_03.c3d',32,EE,B,E,3,Same,19
1154,1169,15,0.832572134,0.925064103,887,920,104,311,'01_01_04.c3d',32,EE,B,E,4,Same,33
1352,1382,30,0.894290047,1.03330285,694,706,247,277,'01_01_05.c3d',32,EE,B,E,5,Same,12
1454,1981,527,1.615767976,1.520392607,1143,1141,851,808,'01_01_01.c3d',33,EE,B,E,1,Same,2
1180,1402,222,1.317408858,1.482205376,657,651,406,1,'01_01_02.c3d',33,EE,B,E,2,Same,6
1110,1280,170,1.052605359,1.255562439,750,778,496,416,'01_01_03.c3d',33,EE,B,E,3,Same,28
948,1051,103,1.300937375,1.581018378,641,585,396,366,'01_01_04.c3d',33,EE,B,E,4,Same,56
1127,1406,279,1.113292058,1.281640427,537,517,300,290,'01_01_05.c3d',33,EE,B,E,5,Same,20
1338,1349,11,1.624992423,1.641629061,894,829,670,658,'01_01_01.c3d',34,EE,B,E,1,Same,65
966,997,31,1.939056432,1.817665158,842,870,578,32,'01_01_02.c3d',34,EE,B,E,2,Same,28
805,881,76,2.074560268,2.205210781,566,594,360,383,'01_01_03.c3d',34,EE,B,E,3,Same,28
910,932,22,1.210770391,1.422750011,474,491,266,259,'01_01_04.c3d',34,EE,B,E,4,Same,17
928,1941,1013,1.344780203,1.537191048,641,513,57,48,'01_01_05.c3d',34,EE,B,E,5,Same,128
764,1127,363,2.090015392,2.11670663,438,469,228,218,'01_01_01.c3d',35,EE,B,E,1,Same,31
742,1042,300,2.001352867,1.829243374,428,493,96,244,'01_01_02.c3d',35,EE,B,E,2,Same,65
919,1102,183,2.240905393,2.222152535,485,509,269,296,'01_01_03.c3d',35,EE,B,E,3,Same,24
824,1271,447,1.55492121,1.70547411,457,507,233,257,'01_01_04.c3d',35,EE,B,E,4,Same,50
959,961,2,1.275600551,1.154040883,520,446,1,1,'01_01_05.c3d',35,EE,B,E,5,Same,74
1326,1859,533,1.044048611,1.288203732,591,642,1,46,'01_02_01.c3d',1,EE,B,M,1,Same,51
1374,2494,1120,0.991921756,1.493709826,554,582,32,382,'01_02_02.c3d',1,EE,B,M,2,Same,28
1184,1551,367,1.541065634,1.310015549,730,759,48,46,'01_02_03.c3d',1,EE,B,M,3,Same,29
1313,1570,257,0.814263677,1.047489619,513,577,273,1,'01_02_04.c3d',1,EE,B,M,4,Same,64
1007,1085,78,1.237724273,1.124269914,504,557,183,1,'01_02_05.c3d',1,EE,B,M,5,Same,53
1441,2196,755,0.862512109,1.454442264,522,937,289,1,'01_02_01.c3d',2,EE,B,M,1,Same,415
1693,3299,1606,0.631318039,0.865274906,539,505,272,1,'01_02_02.c3d',2,EE,B,M,2,Same,34
1349,3171,1822,0.897897401,1.012960868,478,904,195,233,'01_02_03.c3d',2,EE,B,M,3,Same,426
1163,1924,761,0.822511789,1.211068616,579,566,331,1,'01_02_04.c3d',2,EE,B,M,4,Same,13
1856,2391,535,0.931742731,1.197639916,485,475,68,249,'01_02_05.c3d',2,EE,B,M,5,Same,10
780,889,109,1.516911658,2.042515992,549,575,39,1,'01_02_01.c3d',3,EE,B,M,1,Same,26
690,925,235,1.649796517,1.917172938,442,502,265,1,'01_02_02.c3d',3,EE,B,M,2,Same,60
878,928,50,1.805925341,2.028504689,494,518,195,13,'01_02_03.c3d',3,EE,B,M,3,Same,24
733,894,161,1.947036252,1.888325011,447,489,255,276,'01_02_04.c3d',3,EE,B,M,4,Same,42
687,957,270,1.45053629,1.730843931,478,533,1,70,'01_02_05.c3d',3,EE,B,M,5,Same,55
805,1472,667,1.709727652,2.237009329,513,531,320,311,'01_02_01.c3d',4,EE,B,M,1,Same,18
1034,1094,60,1.683243313,1.438651357,734,769,518,59,'01_02_02.c3d',4,EE,B,M,2,Same,35
1005,1007,2,1.732035003,2.118587319,627,539,318,1,'01_02_03.c3d',4,EE,B,M,3,Same,88
1080,1440,360,1.082165887,0.770727845,545,658,22,17,'01_02_04.c3d',4,EE,B,M,4,Same,113
1220,1575,355,1.44817116,1.28425373,687,679,468,1,'01_02_05.c3d',4,EE,B,M,5,Same,8
557,1172,615,2.641901254,2.683076581,373,366,113,199,'01_02_01.c3d',5,EE,B,M,1,Same,7
730,922,192,1.862971616,2.46173022,524,561,63,63,'01_02_02.c3d',5,EE,B,M,2,Same,37
683,698,15,1.722669852,2.484698106,432,439,1,259,'01_02_03.c3d',5,EE,B,M,3,Same,7
126,850,724,2.234674323,1.661201543,152,462,1,1,'01_02_04.c3d',5,EE,B,M,4,Same,310
668,772,104,2.08698104,2.610882379,452,474,281,284,'01_02_05.c3d',5,EE,B,M,5,Same,22
4119,4902,783,0.536796802,0.574276817,3350,2416,150,1,'01_02_01.c3d',6,EE,B,M,1,Same,934
898,1334,436,1.452381623,1.700206531,516,619,299,72,'01_02_02.c3d',6,EE,B,M,2,Same,103
775,803,28,1.409677519,1.643086056,658,622,6,314,'01_02_03.c3d',6,EE,B,M,3,Same,36
823,1161,338,1.374719826,1.605915189,665,623,1,18,'01_02_04.c3d',6,EE,B,M,4,Same,42
1050,1750,700,0.975418799,1.263296945,839,557,59,52,'01_02_05.c3d',6,EE,B,M,5,Same,282
1174,1701,527,1.281886695,1.118066299,554,603,329,320,'01_02_01.c3d',7,EE,B,M,1,Same,49
1144,1431,287,1.511028066,1.552455531,635,648,72,1,'01_02_02.c3d',7,EE,B,M,2,Same,13
972,996,24,1.317620233,1.344286498,571,590,1,71,'01_02_03.c3d',7,EE,B,M,3,Same,19
778,1398,620,1.641194377,1.369350965,468,471,262,123,'01_02_04.c3d',7,EE,B,M,4,Same,3
943,1107,164,1.123844673,1.197596365,537,592,30,321,'01_02_05.c3d',7,EE,B,M,5,Same,55
1399,1525,126,0.956544574,0.966569428,446,458,152,153,'01_02_01.c3d',8,EE,B,M,1,Same,12
2069,2908,839,0.568807141,0.736265445,400,515,186,237,'01_02_02.c3d',8,EE,B,M,2,Same,115
1626,1728,102,0.969554002,0.981688234,500,547,11,286,'01_02_03.c3d',8,EE,B,M,3,Same,47
1086,1808,722,0.696147266,1.044713943,553,653,1,38,'01_02_04.c3d',8,EE,B,M,4,Same,100
1397,1531,134,0.613708701,0.802441963,559,346,1,1,'01_02_05.c3d',8,EE,B,M,5,Same,213
1615,1753,138,1.36776538,1.43575079,730,718,1,1,'01_02_01.c3d',9,EE,B,M,1,Same,12
811,1505,694,0.650838985,2.188199478,491,420,253,259,'01_02_02.c3d',9,EE,B,M,2,Same,71
941,2291,1350,1.299505989,1.846099403,474,433,261,265,'01_02_03.c3d',9,EE,B,M,3,Same,41
944,1568,624,1.43753671,1.494728851,506,472,274,77,'01_02_04.c3d',9,EE,B,M,4,Same,34
1310,1787,477,0.843041826,1.051581845,801,785,263,25,'01_02_05.c3d',9,EE,B,M,5,Same,16
781,1222,441,2.541428806,3.01715139,435,454,277,283,'01_02_01.c3d',10,EE,B,M,1,Same,19
706,1134,428,2.438460528,2.795672282,540,538,324,322,'01_02_02.c3d',10,EE,B,M,2,Same,2
936,1368,432,1.592028614,1.587029479,555,549,353,25,'01_02_03.c3d',10,EE,B,M,3,Same,6
874,950,76,1.208001007,1.668352123,100,124,1,1,'01_02_04.c3d',10,EE,B,M,4,Same,24
825,975,150,1.100025968,1.190024297,134,402,1,1,'01_02_05.c3d',10,EE,B,M,5,Same,268
1385,1657,272,1.078711815,1.012542786,743,756,1,1,'01_02_01.c3d',11,EE,B,M,1,Same,13
1510,1732,222,0.966121287,0.836747032,866,766,345,1,'01_02_02.c3d',11,EE,B,M,2,Same,100
1639,2633,994,0.649661905,0.769263864,734,712,1,1,'01_02_03.c3d',11,EE,B,M,3,Same,22
1604,2365,761,0.565639175,0.693863319,971,842,15,1,'01_02_04.c3d',11,EE,B,M,4,Same,129
1296,1331,35,0.90671862,0.765771544,837,860,339,279,'01_02_05.c3d',11,EE,B,M,5,Same,23
1414,1466,52,1.058509435,0.933065662,688,711,1,1,'01_02_01.c3d',12,EE,B,M,1,Same,23
946,1005,59,1.483095399,1.401768937,470,505,292,275,'01_02_02.c3d',12,EE,B,M,2,Same,35
897,1543,646,1.79290023,1.759651007,449,494,280,265,'01_02_03.c3d',12,EE,B,M,3,Same,45
875,1082,207,1.690159701,1.496509688,520,527,319,325,'01_02_04.c3d',12,EE,B,M,4,Same,7
1000,1209,209,1.360651688,0.875788324,504,534,314,1,'01_02_05.c3d',12,EE,B,M,5,Same,30
993,1354,361,1.468190647,1.761071367,483,545,70,285,'01_02_01.c3d',13,EE,B,M,1,Same,62
853,879,26,1.537944068,1.898314608,538,596,301,306,'01_02_02.c3d',13,EE,B,M,2,Same,58
950,1373,423,1.402020969,1.417126701,494,512,1,37,'01_02_03.c3d',13,EE,B,M,3,Same,18
906,909,3,1.785463273,1.740804963,448,476,130,163,'01_02_04.c3d',13,EE,B,M,4,Same,28
1316,1557,241,1.236738332,1.186102088,588,624,1,339,'01_02_05.c3d',13,EE,B,M,5,Same,36
697,837,140,1.982442414,2.5115975,437,457,1,31,'01_02_01.c3d',14,EE,B,M,1,Same,20
704,738,34,2.142437344,2.922335839,429,454,242,256,'01_02_02.c3d',14,EE,B,M,2,Same,25
921,1405,484,1.809413427,1.93586764,426,485,149,278,'01_02_03.c3d',14,EE,B,M,3,Same,59
826,968,142,2.184432745,2.328760489,412,443,215,254,'01_02_04.c3d',14,EE,B,M,4,Same,31
710,925,215,2.089981366,2.401705117,395,512,241,275,'01_02_05.c3d',14,EE,B,M,5,Same,117
2091,2263,172,0.588472802,0.732725256,1509,1095,1,1,'01_02_01.c3d',15,EE,B,M,1,Same,414
1082,1532,450,1.394668066,1.279185061,535,570,311,1,'01_02_02.c3d',15,EE,B,M,2,Same,35
812,1057,245,1.512388993,1.465712021,450,501,146,128,'01_02_03.c3d',15,EE,B,M,3,Same,51
1206,2001,795,1.46251725,1.556745158,500,492,296,285,'01_02_04.c3d',15,EE,B,M,4,Same,8
872,920,48,1.375642057,1.452313741,441,485,110,1,'01_02_05.c3d',15,EE,B,M,5,Same,44
762,944,182,1.391885216,1.328825944,425,434,1,1,'01_02_01.c3d',16,EE,B,M,1,Same,9
895,944,49,1.563222421,1.971846465,471,472,265,271,'01_02_02.c3d',16,EE,B,M,2,Same,1
900,946,46,1.429220746,1.64579705,417,461,221,219,'01_02_03.c3d',16,EE,B,M,3,Same,44
875,1959,1084,1.471433052,1.464878129,572,585,340,3,'01_02_04.c3d',16,EE,B,M,4,Same,13
977,1177,200,1.973362736,1.600803854,441,530,240,192,'01_02_05.c3d',16,EE,B,M,5,Same,89
602,774,172,3.954088194,3.75557385,432,445,306,314,'01_02_01.c3d',17,EE,B,M,1,Same,13
475,1221,746,3.082773271,3.315995799,371,344,22,139,'01_02_02.c3d',17,EE,B,M,2,Same,27
907,914,7,2.390453733,3.166717694,447,458,289,293,'01_02_03.c3d',17,EE,B,M,3,Same,11
562,989,427,2.578541773,2.668351298,391,398,260,259,'01_02_04.c3d',17,EE,B,M,4,Same,7
753,1256,503,2.61788308,2.743601438,442,439,302,20,'01_02_05.c3d',17,EE,B,M,5,Same,3
896,996,100,1.933794778,1.922280073,552,586,1,1,'01_02_01.c3d',18,EE,B,M,1,Same,34
775,1910,1135,2.78697706,2.783330436,466,494,63,203,'01_02_02.c3d',18,EE,B,M,2,Same,28
782,853,71,1.703275176,1.752310631,487,485,84,16,'01_02_03.c3d',18,EE,B,M,3,Same,2
582,1254,672,2.264841973,1.672554025,480,512,1,1,'01_02_04.c3d',18,EE,B,M,4,Same,32
864,903,39,1.551037574,1.836409711,507,501,275,7,'01_02_05.c3d',18,EE,B,M,5,Same,6
1051,1656,605,0.74799477,1.328748066,495,502,284,271,'01_02_01.c3d',19,EE,B,M,1,Same,7
1188,1672,484,0.77638981,1.086693507,491,485,151,260,'01_02_02.c3d',19,EE,B,M,2,Same,6
921,1442,521,1.148406478,1.62145555,492,495,284,270,'01_02_03.c3d',19,EE,B,M,3,Same,3
768,1064,296,1.198729155,1.423108742,684,422,65,1,'01_02_04.c3d',19,EE,B,M,4,Same,262
875,963,88,1.524553293,1.768688038,502,458,270,104,'01_02_05.c3d',19,EE,B,M,5,Same,44
991,1085,94,1.573574295,1.84350106,603,608,379,1,'01_02_01.c3d',20,EE,B,M,1,Same,5
966,1042,76,1.504704463,1.504645254,549,567,359,329,'01_02_02.c3d',20,EE,B,M,2,Same,18
898,1021,123,1.602034061,1.663126202,468,460,300,284,'01_02_03.c3d',20,EE,B,M,3,Same,8
896,1226,330,1.895532065,1.68335362,541,530,360,349,'01_02_04.c3d',20,EE,B,M,4,Same,11
1097,1280,183,1.465645732,1.348819994,499,492,292,262,'01_02_05.c3d',20,EE,B,M,5,Same,7
1164,1587,423,1.319590404,1.219062349,618,606,1,397,'01_02_01.c3d',21,EE,B,M,1,Same,12
959,1077,118,1.256049402,1.382327791,540,606,343,337,'01_02_02.c3d',21,EE,B,M,2,Same,66
1005,1366,361,1.554962274,1.270262272,606,671,400,400,'01_02_03.c3d',21,EE,B,M,3,Same,65
1246,1723,477,0.969997658,0.938997251,549,608,345,1,'01_02_04.c3d',21,EE,B,M,4,Same,59
1388,1738,350,0.875114838,0.767393164,593,605,358,18,'01_02_05.c3d',21,EE,B,M,5,Same,12
1292,1329,37,0.959322993,1.340523206,600,626,292,331,'01_02_01.c3d',22,EE,B,M,1,Same,26
1032,1644,612,1.017467616,1.526042397,645,940,337,358,'01_02_02.c3d',22,EE,B,M,2,Same,295
1475,1525,50,0.783885142,1.081594164,672,881,341,405,'01_02_03.c3d',22,EE,B,M,3,Same,209
1397,2059,662,0.730915075,1.34436363,930,971,287,367,'01_02_04.c3d',22,EE,B,M,4,Same,41
1230,1457,227,0.821047741,1.353187499,553,813,62,322,'01_02_05.c3d',22,EE,B,M,5,Same,260
2064,4471,2407,0.550557482,0.668058639,563,613,253,279,'01_02_01.c3d',23,EE,B,M,1,Same,50
4626,5076,450,0.445025438,0.463576334,3236,1080,47,1,'01_02_02.c3d',23,EE,B,M,2,Same,2156
3253,3378,125,0.533712734,0.549564153,969,494,250,74,'01_02_03.c3d',23,EE,B,M,3,Same,475
3025,5463,2438,0.400816628,0.68306174,3948,1718,29,1,'01_02_04.c3d',23,EE,B,M,4,Same,2230
3571,4637,1066,0.480240719,0.543733205,616,607,54,72,'01_02_05.c3d',23,EE,B,M,5,Same,9
1267,1663,396,1.500541242,1.969985018,567,547,345,349,'01_02_01.c3d',24,EE,B,M,1,Same,20
939,1297,358,1.53446892,1.6148521,477,500,90,253,'01_02_02.c3d',24,EE,B,M,2,Same,23
1112,1166,54,1.333274853,1.593195819,536,528,77,38,'01_02_03.c3d',24,EE,B,M,3,Same,8
899,1004,105,1.398462862,1.47116777,525,448,282,1,'01_02_04.c3d',24,EE,B,M,4,Same,77
904,1244,340,1.054597771,1.157011293,449,445,134,31,'01_02_05.c3d',24,EE,B,M,5,Same,4
1108,1412,304,1.08652016,0.867471659,640,517,274,281,'01_02_01.c3d',25,EE,B,M,1,Same,123
1187,1910,723,1.751899497,1.669875418,460,473,248,310,'01_02_02.c3d',25,EE,B,M,2,Same,13
983,1397,414,2.696281494,2.853026724,423,423,251,259,'01_02_03.c3d',25,EE,B,M,3,Same,0
1177,2829,1652,0.801543183,0.933092215,753,582,39,343,'01_02_04.c3d',25,EE,B,M,4,Same,171
980,1030,50,1.188149228,1.186693615,496,587,250,257,'01_02_05.c3d',25,EE,B,M,5,Same,91
1615,1681,66,0.918201401,1.349963709,543,532,49,313,'01_02_01.c3d',26,EE,B,M,1,Same,11
1608,1777,169,0.947991782,1.250382829,707,693,1,1,'01_02_02.c3d',26,EE,B,M,2,Same,14
847,3186,2339,0.905944955,1.491048112,570,538,328,53,'01_02_03.c3d',26,EE,B,M,3,Same,32
1019,1200,181,1.228298295,1.529839698,474,498,268,281,'01_02_04.c3d',26,EE,B,M,4,Same,24
1389,1611,222,0.752606967,0.753681353,465,521,1,32,'01_02_05.c3d',26,EE,B,M,5,Same,56
1140,1303,163,1.414216195,1.754208749,573,601,363,351,'01_02_01.c3d',27,EE,B,M,1,Same,28
1264,1283,19,1.408828055,1.357679313,597,655,381,361,'01_02_02.c3d',27,EE,B,M,2,Same,58
1116,1175,59,1.887140542,1.936770114,694,723,461,210,'01_02_03.c3d',27,EE,B,M,3,Same,29
1045,1562,517,1.013707319,1.372119321,540,571,327,311,'01_02_04.c3d',27,EE,B,M,4,Same,31
1252,1414,162,1.360213305,1.272779177,551,562,300,284,'01_02_05.c3d',27,EE,B,M,5,Same,11
1586,3310,1724,0.918410707,1.174411937,2336,664,391,383,'01_02_01.c3d',28,EE,B,M,1,Same,1672
1328,2330,1002,0.954022352,0.87224421,851,608,319,94,'01_02_02.c3d',28,EE,B,M,2,Same,243
1094,1672,578,1.011492533,0.959105694,584,1008,1,295,'01_02_03.c3d',28,EE,B,M,3,Same,424
1128,1157,29,1.03083839,0.849166433,632,961,1,8,'01_02_04.c3d',28,EE,B,M,4,Same,329
1339,1928,589,0.811897109,0.611087182,904,950,1,288,'01_02_05.c3d',28,EE,B,M,5,Same,46
1148,1815,667,1.632965155,1.977584884,577,568,332,355,'01_02_01.c3d',29,EE,B,M,1,Same,9
787,1263,476,1.878194708,2.338658724,602,576,356,381,'01_02_02.c3d',29,EE,B,M,2,Same,26
1372,1857,485,1.382361935,1.422467191,537,546,1,302,'01_02_03.c3d',29,EE,B,M,3,Same,9
901,1001,100,1.334356717,1.576883336,508,486,284,280,'01_02_04.c3d',29,EE,B,M,4,Same,22
802,1404,602,1.174230418,1.47809507,502,479,267,254,'01_02_05.c3d',29,EE,B,M,5,Same,23
1067,1317,250,1.363897588,1.296042174,504,511,275,271,'01_02_01.c3d',30,EE,B,M,1,Same,7
871,1015,144,1.271016704,1.474027153,507,515,276,300,'01_02_02.c3d',30,EE,B,M,2,Same,8
1246,1385,139,0.806307981,0.691520106,519,320,1,26,'01_02_03.c3d',30,EE,B,M,3,Same,199
897,953,56,1.055420677,1.332555605,476,441,141,103,'01_02_04.c3d',30,EE,B,M,4,Same,35
1374,1480,106,1.002032351,0.851923772,530,469,121,1,'01_02_05.c3d',30,EE,B,M,5,Same,61
942,949,7,2.303436575,2.276319394,503,492,311,1,'01_02_01.c3d',31,EE,B,M,1,Same,11
946,1081,135,2.146697001,2.17001851,686,688,429,424,'01_02_02.c3d',31,EE,B,M,2,Same,2
1172,1250,78,1.747061417,1.731437696,509,506,298,284,'01_02_03.c3d',31,EE,B,M,3,Same,3
954,1003,49,1.658520267,1.662456512,563,559,319,315,'01_02_04.c3d',31,EE,B,M,4,Same,4
879,899,20,1.864257495,1.71550707,483,491,271,231,'01_02_05.c3d',31,EE,B,M,5,Same,8
1398,1920,522,1.393537059,1.303566917,599,592,11,397,'01_02_01.c3d',32,EE,B,M,1,Same,7
1377,2610,1233,0.803368177,1.096464159,686,740,357,1,'01_02_02.c3d',32,EE,B,M,2,Same,54
893,1246,353,1.227661998,1.624368083,752,819,389,359,'01_02_03.c3d',32,EE,B,M,3,Same,67
902,988,86,1.319250977,1.492798162,623,662,346,25,'01_02_04.c3d',32,EE,B,M,4,Same,39
1041,1083,42,1.260748607,1.263263329,834,895,319,296,'01_02_05.c3d',32,EE,B,M,5,Same,61
1619,2151,532,0.609003361,0.849548529,783,637,76,91,'01_02_01.c3d',33,EE,B,M,1,Same,146
1168,1433,265,1.042213994,1.211957251,598,562,341,309,'01_02_02.c3d',33,EE,B,M,2,Same,36
1000,1329,329,1.095772088,1.164869249,818,604,332,1,'01_02_03.c3d',33,EE,B,M,3,Same,214
1030,1398,368,1.130144307,1.415611686,728,744,33,390,'01_02_04.c3d',33,EE,B,M,4,Same,16
1073,1097,24,1.129925061,1.379779498,778,634,361,341,'01_02_05.c3d',33,EE,B,M,5,Same,144
1453,1489,36,1.571488499,1.405951756,1013,974,344,338,'01_02_01.c3d',34,EE,B,M,1,Same,39
973,991,18,1.454734918,1.609845887,752,743,42,469,'01_02_02.c3d',34,EE,B,M,2,Same,9
699,1271,572,1.675159888,2.064390028,446,442,268,289,'01_02_03.c3d',34,EE,B,M,3,Same,4
726,734,8,1.678424302,1.801129502,503,500,282,1,'01_02_04.c3d',34,EE,B,M,4,Same,3
981,1115,134,1.071295848,1.322731475,770,598,43,370,'01_02_05.c3d',34,EE,B,M,5,Same,172
850,1016,166,1.704320446,1.900074457,480,455,244,241,'01_02_01.c3d',35,EE,B,M,1,Same,25
1060,1129,69,1.829817314,1.682930996,461,474,1,56,'01_02_02.c3d',35,EE,B,M,2,Same,13
821,1128,307,1.831941675,2.087408014,532,566,347,1,'01_02_03.c3d',35,EE,B,M,3,Same,34
1222,1223,1,1.30526075,1.443068469,465,472,236,221,'01_02_04.c3d',35,EE,B,M,4,Same,7
897,1267,370,1.361681254,1.439745886,434,245,1,1,'01_02_05.c3d',35,EE,B,M,5,Same,189
1503,1718,215,0.720804792,0.874299079,567,640,91,58,'01_03_01.c3d',1,EE,B,H,1,Same,73
1282,1485,203,0.807022842,0.963548424,468,481,210,227,'01_03_02.c3d',1,EE,B,H,2,Same,13
1201,1929,728,0.796400634,1.206467245,587,640,344,1,'01_03_03.c3d',1,EE,B,H,3,Same,53
1054,1057,3,1.116948056,0.963625892,600,617,35,69,'01_03_04.c3d',1,EE,B,H,4,Same,17
1161,1519,358,1.222859648,1.252598739,604,546,1,350,'01_03_05.c3d',1,EE,B,H,5,Same,58
1408,2658,1250,0.5973302,1.110993693,2620,459,128,1,'01_03_01.c3d',2,EE,B,H,1,Same,2161
1387,1677,290,0.971901949,1.235141017,502,429,29,1,'01_03_02.c3d',2,EE,B,H,2,Same,73
1284,2046,762,0.910028085,1.177663325,543,549,1,9,'01_03_03.c3d',2,EE,B,H,3,Same,6
1184,1211,27,1.010956459,1.181154,503,486,241,1,'01_03_04.c3d',2,EE,B,H,4,Same,17
1837,3812,1975,0.810202306,0.788228278,529,1360,28,15,'01_03_05.c3d',2,EE,B,H,5,Same,831
1068,1120,52,1.192549874,1.528957632,551,760,1,1,'01_03_01.c3d',3,EE,B,H,1,Same,209
748,775,27,1.579301891,2.208950571,483,457,293,281,'01_03_02.c3d',3,EE,B,H,2,Same,26
651,820,169,1.349804766,1.725952263,454,319,1,1,'01_03_03.c3d',3,EE,B,H,3,Same,135
870,962,92,1.188801283,1.496269985,527,538,1,1,'01_03_04.c3d',3,EE,B,H,4,Same,11
802,1209,407,1.244519235,1.688331974,485,703,241,297,'01_03_05.c3d',3,EE,B,H,5,Same,218
1152,1534,382,1.299830682,1.161281539,570,719,1,1,'01_03_01.c3d',4,EE,B,H,1,Same,149
909,1045,136,2.018318511,2.089197727,496,480,82,292,'01_03_02.c3d',4,EE,B,H,2,Same,16
983,985,2,1.668013723,1.502410739,547,519,307,86,'01_03_03.c3d',4,EE,B,H,3,Same,28
877,920,43,1.323226758,1.238329156,451,452,247,238,'01_03_04.c3d',4,EE,B,H,4,Same,1
951,1967,1016,0.888538539,1.16499027,628,508,1,265,'01_03_05.c3d',4,EE,B,H,5,Same,120
856,920,64,2.402412109,2.628026432,497,500,336,332,'01_03_01.c3d',5,EE,B,H,1,Same,3
818,1106,288,2.867044596,3.48602657,479,485,327,346,'01_03_02.c3d',5,EE,B,H,2,Same,6
631,1735,1104,1.960425807,2.017708362,374,366,236,210,'01_03_03.c3d',5,EE,B,H,3,Same,8
665,749,84,2.544464189,2.89208196,361,396,152,109,'01_03_04.c3d',5,EE,B,H,4,Same,35
667,704,37,2.023943046,2.406337747,453,452,285,279,'01_03_05.c3d',5,EE,B,H,5,Same,1
1190,1418,228,1.003937988,1.703547871,686,645,16,431,'01_03_01.c3d',6,EE,B,H,1,Same,41
1046,1222,176,1.328654783,1.684355719,647,755,425,1,'01_03_02.c3d',6,EE,B,H,2,Same,108
749,764,15,1.597130357,1.583449813,578,577,1,1,'01_03_03.c3d',6,EE,B,H,3,Same,1
894,1763,869,1.04543393,1.111739158,718,589,1,4,'01_03_04.c3d',6,EE,B,H,4,Same,129
1059,1817,758,1.218309943,1.108093688,576,564,1,1,'01_03_05.c3d',6,EE,B,H,5,Same,12
1017,1683,666,1.215948339,1.321985525,516,501,200,1,'01_03_01.c3d',7,EE,B,H,1,Same,15
755,934,179,1.728331805,1.427037925,452,484,264,220,'01_03_02.c3d',7,EE,B,H,2,Same,32
607,1091,484,1.323244747,0.881072095,517,66,1,1,'01_03_03.c3d',7,EE,B,H,3,Same,451
1092,1342,250,1.141155043,1.005340219,409,406,184,1,'01_03_04.c3d',7,EE,B,H,4,Same,3
876,899,23,1.265843772,1.051203254,468,435,30,1,'01_03_05.c3d',7,EE,B,H,5,Same,33
1339,1782,443,1.155861768,0.999186651,590,577,101,1,'01_03_01.c3d',8,EE,B,H,1,Same,13
1404,1412,8,0.786594246,0.867098977,507,525,279,62,'01_03_02.c3d',8,EE,B,H,2,Same,18
1274,2046,772,0.76433739,0.795366085,358,723,120,149,'01_03_03.c3d',8,EE,B,H,3,Same,365
1336,1775,439,0.936390585,1.129454272,485,455,232,245,'01_03_04.c3d',8,EE,B,H,4,Same,30
1171,1259,88,0.784298913,0.982674792,459,393,1,1,'01_03_05.c3d',8,EE,B,H,5,Same,66
1035,2040,1005,1.018676621,2.02063934,582,595,378,50,'01_03_01.c3d',9,EE,B,H,1,Same,13
1263,1503,240,1.434508745,2.022724778,452,430,258,266,'01_03_02.c3d',9,EE,B,H,2,Same,22
1466,1797,331,1.080623914,1.614748333,548,485,1,291,'01_03_03.c3d',9,EE,B,H,3,Same,63
951,1752,801,1.484560102,1.729523941,449,429,280,268,'01_03_04.c3d',9,EE,B,H,4,Same,20
967,1867,900,1.402850954,1.563383526,502,476,315,298,'01_03_05.c3d',9,EE,B,H,5,Same,26
978,991,13,2.414744147,2.695068551,484,476,310,291,'01_03_01.c3d',10,EE,B,H,1,Same,8
1051,1131,80,2.140083482,2.569509145,541,533,369,333,'01_03_02.c3d',10,EE,B,H,2,Same,8
802,1556,754,1.659088674,2.32553153,587,506,315,296,'01_03_03.c3d',10,EE,B,H,3,Same,81
758,1127,369,1.648689411,2.366804029,438,446,18,1,'01_03_04.c3d',10,EE,B,H,4,Same,8
908,921,13,1.651996903,2.098590181,451,460,261,267,'01_03_05.c3d',10,EE,B,H,5,Same,9
1746,2377,631,0.612394319,0.663997191,859,975,314,330,'01_03_01.c3d',11,EE,B,H,1,Same,116
1634,1642,8,0.606302757,0.60803891,729,724,402,152,'01_03_02.c3d',11,EE,B,H,2,Same,5
2067,2154,87,0.691840073,0.778799207,1131,688,399,374,'01_03_03.c3d',11,EE,B,H,3,Same,443
1390,1451,61,0.730868697,0.777184481,720,791,105,58,'01_03_04.c3d',11,EE,B,H,4,Same,71
1799,2476,677,0.775896863,0.846335994,1075,1068,403,340,'01_03_05.c3d',11,EE,B,H,5,Same,7
828,1167,339,2.068869263,1.963829479,425,439,279,266,'01_03_01.c3d',12,EE,B,H,1,Same,14
934,1404,470,1.540592905,1.53238366,491,530,30,308,'01_03_02.c3d',12,EE,B,H,2,Same,39
1071,1765,694,1.161655975,1.241614676,581,567,1,368,'01_03_03.c3d',12,EE,B,H,3,Same,14
822,981,159,1.780073318,1.753031858,494,547,332,181,'01_03_04.c3d',12,EE,B,H,4,Same,53
974,995,21,1.534748576,1.494562992,413,439,206,1,'01_03_05.c3d',12,EE,B,H,5,Same,26
1927,2261,334,0.924028796,0.786236959,658,1107,1,1,'01_03_01.c3d',13,EE,B,H,1,Same,449
1025,1364,339,1.338581225,1.397436311,474,525,259,1,'01_03_02.c3d',13,EE,B,H,2,Same,51
1293,1361,68,1.512861062,1.416888765,501,542,49,20,'01_03_03.c3d',13,EE,B,H,3,Same,41
1063,1078,15,1.806707743,1.750937175,598,549,244,284,'01_03_04.c3d',13,EE,B,H,4,Same,49
1126,1463,337,1.347626409,1.660671903,640,585,379,376,'01_03_05.c3d',13,EE,B,H,5,Same,55
654,965,311,2.086623622,2.87353417,410,450,237,249,'01_03_01.c3d',14,EE,B,H,1,Same,40
831,893,62,2.189452532,2.761999639,431,461,267,37,'01_03_02.c3d',14,EE,B,H,2,Same,30
765,848,83,2.014243094,2.127450907,372,405,38,252,'01_03_03.c3d',14,EE,B,H,3,Same,33
819,944,125,1.810842985,1.655359681,424,455,42,1,'01_03_04.c3d',14,EE,B,H,4,Same,31
886,1371,485,1.631913762,1.358925728,568,666,39,335,'01_03_05.c3d',14,EE,B,H,5,Same,98
894,901,7,1.298385065,1.454262563,447,457,105,151,'01_03_01.c3d',15,EE,B,H,1,Same,10
843,859,16,1.417745398,1.610881947,471,518,1,1,'01_03_02.c3d',15,EE,B,H,2,Same,47
858,1031,173,1.739653747,1.815684106,430,486,232,1,'01_03_03.c3d',15,EE,B,H,3,Same,56
1223,1476,253,1.3328146,1.429694019,541,549,1,322,'01_03_04.c3d',15,EE,B,H,4,Same,8
914,1002,88,1.403251347,1.353548392,510,522,48,228,'01_03_05.c3d',15,EE,B,H,5,Same,12
824,915,91,1.516190669,1.655730798,468,466,1,1,'01_03_01.c3d',16,EE,B,H,1,Same,2
932,1425,493,1.403417397,2.018505696,439,446,257,1,'01_03_02.c3d',16,EE,B,H,2,Same,7
758,960,202,1.718183881,1.604914991,472,478,263,10,'01_03_03.c3d',16,EE,B,H,3,Same,6
896,2731,1835,1.591058166,1.375431377,501,457,81,7,'01_03_04.c3d',16,EE,B,H,4,Same,44
1095,1158,63,1.428749417,1.312778662,580,447,267,66,'01_03_05.c3d',16,EE,B,H,5,Same,133
716,1015,299,2.749844909,3.353608525,394,397,99,272,'01_03_01.c3d',17,EE,B,H,1,Same,3
726,876,150,2.179994021,2.554037001,444,459,292,79,'01_03_02.c3d',17,EE,B,H,2,Same,15
582,594,12,2.852551835,2.985387326,419,440,273,288,'01_03_03.c3d',17,EE,B,H,3,Same,21
712,916,204,2.065799651,2.234450144,448,449,304,302,'01_03_04.c3d',17,EE,B,H,4,Same,1
883,896,13,3.464212271,2.392996675,444,439,272,49,'01_03_05.c3d',17,EE,B,H,5,Same,5
1841,2019,178,1.348218051,1.620920995,681,667,414,438,'01_03_01.c3d',18,EE,B,H,1,Same,14
1007,1057,50,1.444761053,2.34852264,644,664,481,1,'01_03_02.c3d',18,EE,B,H,2,Same,20
822,1002,180,1.706430434,2.425469046,581,556,1,1,'01_03_03.c3d',18,EE,B,H,3,Same,25
806,821,15,1.982303818,1.792136842,430,463,190,29,'01_03_04.c3d',18,EE,B,H,4,Same,33
1097,1310,213,1.471788956,1.632645274,744,787,362,321,'01_03_05.c3d',18,EE,B,H,5,Same,43
2069,2214,145,0.563860486,0.611511291,1103,888,1,1,'01_03_01.c3d',19,EE,B,H,1,Same,215
1072,1167,95,0.943408411,0.99991112,532,513,23,276,'01_03_02.c3d',19,EE,B,H,2,Same,19
865,952,87,1.429832808,1.787939337,591,536,1,53,'01_03_03.c3d',19,EE,B,H,3,Same,55
1164,1616,452,1.106409522,1.495569265,457,449,247,264,'01_03_04.c3d',19,EE,B,H,4,Same,8
1218,1939,721,1.037099609,1.691373761,454,468,270,38,'01_03_05.c3d',19,EE,B,H,5,Same,14
1245,1895,650,0.939794566,1.220850635,617,617,1,426,'01_03_01.c3d',20,EE,B,H,1,Same,0
1090,1756,666,1.817250017,2.038594524,660,680,495,104,'01_03_02.c3d',20,EE,B,H,2,Same,20
1030,1525,495,1.337012812,1.355068473,555,567,348,340,'01_03_03.c3d',20,EE,B,H,3,Same,12
1323,3580,2257,1.198846798,1.180934684,511,514,314,66,'01_03_04.c3d',20,EE,B,H,4,Same,3
1111,1145,34,1.354102787,1.479527345,577,508,362,343,'01_03_05.c3d',20,EE,B,H,5,Same,69
1053,1059,6,1.350526006,1.393884943,609,606,75,414,'01_03_01.c3d',21,EE,B,H,1,Same,3
1097,1273,176,1.271323704,1.16159385,517,567,303,66,'01_03_02.c3d',21,EE,B,H,2,Same,50
1241,1464,223,1.18286037,1.020919591,657,673,474,1,'01_03_03.c3d',21,EE,B,H,3,Same,16
1045,1405,360,1.27778061,1.198026471,552,569,334,315,'01_03_04.c3d',21,EE,B,H,4,Same,17
1255,1278,23,1.112539005,1.024192619,831,507,1,15,'01_03_05.c3d',21,EE,B,H,5,Same,324
1135,1592,457,1.185504051,1.828590542,563,691,322,330,'01_03_01.c3d',22,EE,B,H,1,Same,128
1282,1447,165,1.267491998,1.392275495,736,769,1,1,'01_03_02.c3d',22,EE,B,H,2,Same,33
1354,1441,87,0.963035335,1.247426398,840,964,458,485,'01_03_03.c3d',22,EE,B,H,3,Same,124
1653,2585,932,0.794709573,1.055175257,720,948,368,1,'01_03_04.c3d',22,EE,B,H,4,Same,228
1321,1911,590,0.99927613,0.971991582,572,563,287,1,'01_03_05.c3d',22,EE,B,H,5,Same,9
5547,6356,809,0.626469464,0.645659732,1030,1049,265,1,'01_03_01.c3d',23,EE,B,H,1,Same,19
3114,4034,920,0.453945719,0.521100261,3644,618,8,52,'01_03_02.c3d',23,EE,B,H,2,Same,3026
3188,8597,5409,0.73632879,0.657481681,856,1438,70,506,'01_03_03.c3d',23,EE,B,H,3,Same,582
2502,4373,1871,0.644370364,0.635433951,2965,1895,350,75,'01_03_04.c3d',23,EE,B,H,4,Same,1070
4969,5706,737,0.384496117,0.616458704,3814,2499,2,303,'01_03_05.c3d',23,EE,B,H,5,Same,1315
1106,1378,272,0.991992367,1.045200474,453,500,261,1,'01_03_01.c3d',24,EE,B,H,1,Same,47
898,947,49,1.255624326,1.319895513,486,459,1,250,'01_03_02.c3d',24,EE,B,H,2,Same,27
1009,1152,143,1.045185228,1.43899403,502,500,293,1,'01_03_03.c3d',24,EE,B,H,3,Same,2
959,2026,1067,1.581149938,1.513352246,504,511,253,37,'01_03_04.c3d',24,EE,B,H,4,Same,7
946,971,25,1.196165764,1.612481578,413,549,180,1,'01_03_05.c3d',24,EE,B,H,5,Same,136
1030,1089,59,1.504555412,1.670908965,538,525,232,259,'01_03_01.c3d',25,EE,B,H,1,Same,13
1505,1611,106,1.019920107,0.992521759,474,478,259,274,'01_03_02.c3d',25,EE,B,H,2,Same,4
1092,1209,117,1.398104183,1.500369347,518,517,1,249,'01_03_03.c3d',25,EE,B,H,3,Same,1
922,1100,178,1.537528601,1.554262342,442,414,213,215,'01_03_04.c3d',25,EE,B,H,4,Same,28
1070,2472,1402,1.169128572,1.000385617,529,512,294,276,'01_03_05.c3d',25,EE,B,H,5,Same,17
1497,3222,1725,0.80487922,1.431074264,639,634,7,81,'01_03_01.c3d',26,EE,B,H,1,Same,5
2005,2483,478,1.12630713,1.157541288,680,690,131,468,'01_03_02.c3d',26,EE,B,H,2,Same,10
1494,1948,454,0.752551606,0.841523499,572,908,1,279,'01_03_03.c3d',26,EE,B,H,3,Same,336
823,2185,1362,1.118402203,1.127807434,410,415,173,72,'01_03_04.c3d',26,EE,B,H,4,Same,5
4471,5406,935,1.120570601,0.751719345,3579,3925,310,178,'01_03_05.c3d',26,EE,B,H,5,Same,346
1236,1813,577,1.284774731,1.303419894,601,668,358,1,'01_03_01.c3d',27,EE,B,H,1,Same,67
1368,1591,223,1.427197064,1.315977979,711,734,1,1,'01_03_02.c3d',27,EE,B,H,2,Same,23
1694,2259,565,0.71665487,0.906338882,810,785,466,1,'01_03_03.c3d',27,EE,B,H,3,Same,25
2019,2074,55,0.746174585,0.756369722,1092,778,1,422,'01_03_04.c3d',27,EE,B,H,4,Same,314
1538,2180,642,0.893845302,0.864976039,1001,1025,63,1,'01_03_05.c3d',27,EE,B,H,5,Same,24
1278,2949,1671,0.91837111,0.924489318,538,2205,317,1,'01_03_01.c3d',28,EE,B,H,1,Same,1667
1453,2519,1066,0.726492896,1.370298157,1841,762,1,518,'01_03_02.c3d',28,EE,B,H,2,Same,1079
1217,1234,17,1.059637609,1.200720377,434,497,240,242,'01_03_03.c3d',28,EE,B,H,3,Same,63
1301,2098,797,0.995685929,1.029703408,546,569,107,1,'01_03_04.c3d',28,EE,B,H,4,Same,23
1548,1964,416,0.762379596,0.864839614,533,552,1,1,'01_03_05.c3d',28,EE,B,H,5,Same,19
1115,2467,1352,1.822876397,2.509589985,621,607,443,447,'01_03_01.c3d',29,EE,B,H,1,Same,14
1128,1659,531,1.151495101,1.148050856,509,515,303,1,'01_03_02.c3d',29,EE,B,H,2,Same,6
1950,2469,519,1.243583531,1.003784492,1528,1451,1,1,'01_03_03.c3d',29,EE,B,H,3,Same,77
1341,1459,118,0.921188044,0.985073237,439,468,18,1,'01_03_04.c3d',29,EE,B,H,4,Same,29
1407,2197,790,0.975430154,0.939618836,551,501,306,272,'01_03_05.c3d',29,EE,B,H,5,Same,50
988,1461,473,1.462394365,1.661707876,604,584,390,378,'01_03_01.c3d',30,EE,B,H,1,Same,20
1037,1057,20,1.562323993,1.886898216,494,478,1,275,'01_03_02.c3d',30,EE,B,H,2,Same,16
919,1049,130,1.248272565,1.495205897,491,460,263,273,'01_03_03.c3d',30,EE,B,H,3,Same,31
1218,1220,2,0.954762893,1.076037956,504,469,275,1,'01_03_04.c3d',30,EE,B,H,4,Same,35
1108,1447,339,1.143058469,1.315699571,552,502,1,268,'01_03_05.c3d',30,EE,B,H,5,Same,50
923,1497,574,2.685252221,2.64692788,496,482,287,290,'01_03_01.c3d',31,EE,B,H,1,Same,14
945,957,12,1.776923132,1.948202568,624,582,72,349,'01_03_02.c3d',31,EE,B,H,2,Same,42
923,959,36,1.565341009,1.485064985,579,572,352,338,'01_03_03.c3d',31,EE,B,H,3,Same,7
1039,1180,141,1.944543941,1.745293803,508,495,313,296,'01_03_04.c3d',31,EE,B,H,4,Same,13
924,2174,1250,2.115786954,1.739829737,552,592,344,320,'01_03_05.c3d',31,EE,B,H,5,Same,40
818,1805,987,1.44525145,1.471298159,499,493,291,45,'01_03_01.c3d',32,EE,B,H,1,Same,6
1312,2842,1530,0.980967397,1.467300393,1232,868,69,379,'01_03_02.c3d',32,EE,B,H,2,Same,364
1260,1891,631,0.842927362,1.175447593,804,773,18,3,'01_03_03.c3d',32,EE,B,H,3,Same,31
1304,1349,45,1.153330202,1.292648076,630,595,327,322,'01_03_04.c3d',32,EE,B,H,4,Same,35
1094,1238,144,0.980982269,0.969602904,653,863,66,330,'01_03_05.c3d',32,EE,B,H,5,Same,210
1910,8838,6928,0.834540595,1.381053471,944,7690,92,392,'01_03_01.c3d',33,EE,B,H,1,Same,6746
1315,1540,225,1.089103365,1.294041283,840,780,569,547,'01_03_02.c3d',33,EE,B,H,2,Same,60
1187,1500,313,0.851245539,0.969996561,611,575,300,96,'01_03_03.c3d',33,EE,B,H,3,Same,36
1325,1614,289,0.866769301,0.908744823,1167,1137,428,1,'01_03_04.c3d',33,EE,B,H,4,Same,30
1146,1279,133,1.237133383,1.365191586,498,509,306,298,'01_03_05.c3d',33,EE,B,H,5,Same,11
899,1866,967,1.320746368,1.521827647,742,658,1,428,'01_03_01.c3d',34,EE,B,H,1,Same,84
1107,1116,9,1.594500039,1.466326505,542,513,337,1,'01_03_02.c3d',34,EE,B,H,2,Same,29
726,746,20,1.779679949,1.829558765,412,424,237,262,'01_03_03.c3d',34,EE,B,H,3,Same,12
875,1019,144,1.144217654,1.393123853,438,424,240,235,'01_03_04.c3d',34,EE,B,H,4,Same,14
1281,1439,158,1.127298841,1.0357172,787,884,434,40,'01_03_05.c3d',34,EE,B,H,5,Same,97
1063,1093,30,1.659353901,1.694772168,417,423,134,237,'01_03_01.c3d',35,EE,B,H,1,Same,6
1219,1241,22,1.11452517,1.202225143,487,816,129,1,'01_03_02.c3d',35,EE,B,H,2,Same,329
855,1017,162,1.629325565,1.551587745,473,466,230,236,'01_03_03.c3d',35,EE,B,H,3,Same,7
892,1274,382,1.304247569,1.098100709,246,231,11,6,'01_03_04.c3d',35,EE,B,H,4,Same,15
1096,1233,137,1.451108114,1.280059669,416,407,78,1,'01_03_05.c3d',35,EE,B,H,5,Same,9
747,1390,643,1.100808083,1.554720151,656,730,425,38,'01_04_01.c3d',1,EE,L,E,1,Same,74
918,1435,517,0.690902301,1.184081199,602,692,369,1,'01_04_02.c3d',1,EE,L,E,2,Same,90
662,1180,518,0.936565921,1.499335495,546,628,1,25,'01_04_03.c3d',1,EE,L,E,3,Same,82
787,2877,2090,0.878439194,1.252080148,727,650,391,1,'01_04_04.c3d',1,EE,L,E,4,Same,77
548,1489,941,1.163135685,1.25762824,450,469,244,36,'01_04_05.c3d',1,EE,L,E,5,Same,19
2205,2894,689,0.805031524,1.035615339,751,1927,1,573,'01_04_01.c3d',2,EE,L,E,1,Same,1176
923,1035,112,0.741164088,1.218865465,444,727,242,21,'01_04_02.c3d',2,EE,L,E,2,Same,283
785,2864,2079,0.71432972,0.873945898,572,1882,1,1,'01_04_03.c3d',2,EE,L,E,3,Same,1310
691,1524,833,0.727950187,0.862168742,615,1144,37,1,'01_04_04.c3d',2,EE,L,E,4,Same,529
774,1198,424,0.997142239,1.214939704,535,515,290,1,'01_04_05.c3d',2,EE,L,E,5,Same,20
498,1190,692,1.370658008,1.717143614,459,511,81,226,'01_04_01.c3d',3,EE,L,E,1,Same,52
536,835,299,1.062750952,1.660510999,443,479,1,264,'01_04_02.c3d',3,EE,L,E,2,Same,36
534,1020,486,1.145274287,1.636398154,467,544,258,185,'01_04_03.c3d',3,EE,L,E,3,Same,77
531,1046,515,1.302704389,1.913712486,439,479,287,1,'01_04_04.c3d',3,EE,L,E,4,Same,40
718,1419,701,1.066380924,1.727773547,408,653,41,265,'01_04_05.c3d',3,EE,L,E,5,Same,245
1124,1206,82,0.814197588,1.364882642,626,674,1,85,'01_04_01.c3d',4,EE,L,E,1,Same,48
826,2414,1588,1.266871481,2.00834915,715,772,538,570,'01_04_02.c3d',4,EE,L,E,2,Same,57
696,860,164,1.199753862,1.67604712,596,632,424,1,'01_04_03.c3d',4,EE,L,E,3,Same,36
658,843,185,1.004608609,1.60327718,483,569,268,279,'01_04_04.c3d',4,EE,L,E,4,Same,86
462,1056,594,0.612620739,1.029903184,322,354,1,23,'01_04_05.c3d',4,EE,L,E,5,Same,32
2011,2256,245,1.000599656,1.131790247,564,577,53,423,'01_04_01.c3d',5,EE,L,E,1,Same,13
683,1217,534,1.873946135,3.065814971,538,571,1,406,'01_04_02.c3d',5,EE,L,E,2,Same,33
481,1426,945,1.594698414,1.973531041,431,501,54,143,'01_04_03.c3d',5,EE,L,E,3,Same,70
780,835,55,1.674012605,2.607800227,423,463,251,292,'01_04_04.c3d',5,EE,L,E,4,Same,40
581,696,115,1.651411742,3.086400024,378,403,232,233,'01_04_05.c3d',5,EE,L,E,5,Same,25
722,1786,1064,0.916930862,1.093753356,625,573,1,391,'01_04_01.c3d',6,EE,L,E,1,Same,52
619,1025,406,0.950751545,1.51871443,493,879,1,292,'01_04_02.c3d',6,EE,L,E,2,Same,386
611,1412,801,1.281859253,0.943094815,520,1063,44,304,'01_04_03.c3d',6,EE,L,E,3,Same,543
586,1397,811,1.036663676,1.675181948,471,958,294,1,'01_04_04.c3d',6,EE,L,E,4,Same,487
554,905,351,1.086885362,1.456774779,447,466,98,105,'01_04_05.c3d',6,EE,L,E,5,Same,19
740,1062,322,0.768251416,0.974400389,571,561,8,50,'01_04_01.c3d',7,EE,L,E,1,Same,10
585,786,201,0.91019187,1.631410812,457,480,1,209,'01_04_02.c3d',7,EE,L,E,2,Same,23
526,865,339,1.074688724,1.295098331,420,481,1,80,'01_04_03.c3d',7,EE,L,E,3,Same,61
568,1201,633,1.099857366,1.172470877,472,555,277,1,'01_04_04.c3d',7,EE,L,E,4,Same,83
637,2508,1871,1.134878585,1.14953132,499,614,335,19,'01_04_05.c3d',7,EE,L,E,5,Same,115
576,1346,770,1.048036543,1.461134876,473,548,284,61,'01_04_01.c3d',8,EE,L,E,1,Same,75
1029,1094,65,0.716395872,1.088933772,466,567,1,1,'01_04_02.c3d',8,EE,L,E,2,Same,101
967,1611,644,0.951236115,1.242390018,383,468,177,1,'01_04_03.c3d',8,EE,L,E,3,Same,85
825,1172,347,0.809155533,1.288633725,450,554,229,1,'01_04_04.c3d',8,EE,L,E,4,Same,104
989,1039,50,0.599657152,1.060953353,387,437,119,180,'01_04_05.c3d',8,EE,L,E,5,Same,50
989,1945,956,0.45824597,1.826728706,715,497,1,341,'01_04_01.c3d',9,EE,L,E,1,Same,218
784,1823,1039,0.825458644,1.241663283,440,462,212,242,'01_04_02.c3d',9,EE,L,E,2,Same,22
751,2788,2037,1.192989119,1.901426438,422,425,245,247,'01_04_03.c3d',9,EE,L,E,3,Same,3
1024,1106,82,1.18520506,1.365437078,628,760,1,368,'01_04_04.c3d',9,EE,L,E,4,Same,132
907,1394,487,0.803951688,1.614221009,468,540,296,82,'01_04_05.c3d',9,EE,L,E,5,Same,72
851,1772,921,1.861750776,3.933084292,703,656,584,431,'01_04_01.c3d',10,EE,L,E,1,Same,47
946,966,20,1.072922357,2.83114478,487,523,1,333,'01_04_02.c3d',10,EE,L,E,2,Same,36
813,872,59,0.852387166,2.784516787,532,529,267,289,'01_04_03.c3d',10,EE,L,E,3,Same,3
876,1407,531,0.708251317,1.727035489,441,482,1,263,'01_04_04.c3d',10,EE,L,E,4,Same,41
651,786,135,1.034084232,2.170346908,359,413,183,229,'01_04_05.c3d',10,EE,L,E,5,Same,54
748,2806,2058,1.425998525,1.801576968,561,605,1,1,'01_04_01.c3d',11,EE,L,E,1,Same,44
1104,3330,2226,0.545305305,0.806867825,642,633,48,337,'01_04_02.c3d',11,EE,L,E,2,Same,9
1025,1983,958,0.518573496,0.771855553,741,775,1,1,'01_04_03.c3d',11,EE,L,E,3,Same,34
1193,1799,606,0.421529772,0.760790738,1151,1032,291,286,'01_04_04.c3d',11,EE,L,E,4,Same,119
1142,1608,466,0.435415949,0.591182733,607,1021,1,1,'01_04_05.c3d',11,EE,L,E,5,Same,414
471,884,413,1.4452894,1.610985172,430,438,247,251,'01_04_01.c3d',12,EE,L,E,1,Same,8
627,1093,466,1.171604241,1.118985922,560,604,1,369,'01_04_02.c3d',12,EE,L,E,2,Same,44
474,660,186,1.604646018,1.963719388,412,439,267,257,'01_04_03.c3d',12,EE,L,E,3,Same,27
479,935,456,0.955223874,1.720172367,401,485,123,161,'01_04_04.c3d',12,EE,L,E,4,Same,84
545,873,328,1.016981682,1.523816732,429,464,1,226,'01_04_05.c3d',12,EE,L,E,5,Same,35
588,1124,536,1.098637467,1.737584035,492,543,273,281,'01_04_01.c3d',13,EE,L,E,1,Same,51
520,1154,634,1.412091164,2.054049605,466,493,281,1,'01_04_02.c3d',13,EE,L,E,2,Same,27
497,1779,1282,1.191423298,1.687380712,425,469,216,31,'01_04_03.c3d',13,EE,L,E,3,Same,44
509,1041,532,1.295294877,1.808958922,439,512,236,275,'01_04_04.c3d',13,EE,L,E,4,Same,73
510,828,318,1.266800715,1.911467512,460,490,139,243,'01_04_05.c3d',13,EE,L,E,5,Same,30
467,888,421,1.539422823,2.19532836,412,468,1,58,'01_04_01.c3d',14,EE,L,E,1,Same,56
543,1647,1104,1.481462159,2.361336538,488,566,310,5,'01_04_02.c3d',14,EE,L,E,2,Same,78
360,825,465,1.736772145,2.509308616,341,406,72,171,'01_04_03.c3d',14,EE,L,E,3,Same,65
384,794,410,1.59530854,1.729527081,354,432,47,197,'01_04_04.c3d',14,EE,L,E,4,Same,78
728,1706,978,1.29144593,2.268581542,378,420,15,113,'01_04_05.c3d',14,EE,L,E,5,Same,42
883,986,103,1.059231635,1.820730945,432,475,96,1,'01_04_01.c3d',15,EE,L,E,1,Same,43
564,955,391,0.896518301,1.280652057,393,594,199,1,'01_04_02.c3d',15,EE,L,E,2,Same,201
487,953,466,1.263125075,1.551939374,403,437,189,175,'01_04_03.c3d',15,EE,L,E,3,Same,34
670,822,152,0.797987542,1.667128013,367,446,103,100,'01_04_04.c3d',15,EE,L,E,4,Same,79
577,838,261,0.815504425,1.199431444,357,488,1,25,'01_04_05.c3d',15,EE,L,E,5,Same,131
921,1571,650,0.841772907,1.074284264,574,656,24,409,'01_04_01.c3d',16,EE,L,E,1,Same,82
944,1800,856,1.092403696,1.593923636,470,493,1,302,'01_04_02.c3d',16,EE,L,E,2,Same,23
1028,1414,386,1.113376335,1.313991471,404,453,130,90,'01_04_03.c3d',16,EE,L,E,3,Same,49
558,2195,1637,1.13395781,1.802044705,444,475,264,278,'01_04_04.c3d',16,EE,L,E,4,Same,31
572,2182,1610,1.056025777,1.268647345,437,499,1,261,'01_04_05.c3d',16,EE,L,E,5,Same,62
446,743,297,1.558586912,2.352680377,379,415,244,246,'01_04_01.c3d',17,EE,L,E,1,Same,36
538,795,257,1.93696408,2.339439024,404,441,293,32,'01_04_02.c3d',17,EE,L,E,2,Same,37
365,645,280,1.852914842,2.853193984,341,414,167,172,'01_04_03.c3d',17,EE,L,E,3,Same,73
441,790,349,1.724977002,2.75862305,411,445,153,261,'01_04_04.c3d',17,EE,L,E,4,Same,34
376,1659,1283,2.29954886,3.374919448,342,388,241,244,'01_04_05.c3d',17,EE,L,E,5,Same,46
518,1283,765,1.381005964,2.135012894,454,511,138,1,'01_04_01.c3d',18,EE,L,E,1,Same,57
1056,1109,53,1.483146935,2.209399584,477,510,280,1,'01_04_02.c3d',18,EE,L,E,2,Same,33
428,1115,687,1.066445117,1.281662982,396,649,1,1,'01_04_03.c3d',18,EE,L,E,3,Same,253
419,1009,590,1.35869373,1.822139252,376,446,1,12,'01_04_04.c3d',18,EE,L,E,4,Same,70
572,1504,932,1.09309261,1.647584948,481,582,251,1,'01_04_05.c3d',18,EE,L,E,5,Same,101
462,1446,984,1.118868665,1.76267039,384,410,1,151,'01_04_01.c3d',19,EE,L,E,1,Same,26
848,944,96,0.960328942,1.591702127,475,498,297,299,'01_04_02.c3d',19,EE,L,E,2,Same,23
577,934,357,0.941788772,1.695253871,469,584,1,286,'01_04_03.c3d',19,EE,L,E,3,Same,115
646,776,130,0.794641518,1.363219752,472,441,130,229,'01_04_04.c3d',19,EE,L,E,4,Same,31
661,945,284,0.905875497,1.301798283,561,555,72,349,'01_04_05.c3d',19,EE,L,E,5,Same,6
1134,1757,623,0.723033259,1.145849021,657,714,1,1,'01_04_01.c3d',20,EE,L,E,1,Same,57
628,1002,374,1.197592762,1.949961218,522,544,350,332,'01_04_02.c3d',20,EE,L,E,2,Same,22
625,1292,667,0.981576263,1.586049127,463,486,1,94,'01_04_03.c3d',20,EE,L,E,3,Same,23
574,834,260,1.059182755,1.704848247,432,440,255,249,'01_04_04.c3d',20,EE,L,E,4,Same,8
962,997,35,0.860043343,1.721054399,516,505,322,294,'01_04_05.c3d',20,EE,L,E,5,Same,11
766,1267,501,1.124872425,1.534790065,602,623,421,1,'01_04_01.c3d',21,EE,L,E,1,Same,21
632,1125,493,1.047569259,1.414283942,497,607,1,317,'01_04_02.c3d',21,EE,L,E,2,Same,110
705,1207,502,1.277574983,1.871096178,506,812,279,366,'01_04_03.c3d',21,EE,L,E,3,Same,306
583,1340,757,1.115873583,1.096429864,568,547,1,1,'01_04_04.c3d',21,EE,L,E,4,Same,21
957,1186,229,1.010661342,1.38891726,609,663,386,1,'01_04_05.c3d',21,EE,L,E,5,Same,54
642,1086,444,1.254768544,1.432085558,469,692,291,306,'01_04_01.c3d',22,EE,L,E,1,Same,223
622,1383,761,1.278376957,1.373357529,521,866,296,1,'01_04_02.c3d',22,EE,L,E,2,Same,345
979,1939,960,0.822961715,0.809879089,572,680,373,21,'01_04_03.c3d',22,EE,L,E,3,Same,108
668,1597,929,1.059191207,0.970130213,530,777,280,337,'01_04_04.c3d',22,EE,L,E,4,Same,247
857,1661,804,0.789490951,0.728989898,525,1005,256,308,'01_04_05.c3d',22,EE,L,E,5,Same,480
1026,3659,2633,0.494012881,0.707248858,519,625,87,259,'01_04_01.c3d',23,EE,L,E,1,Same,106
1325,3968,2643,0.602406713,0.5403993,855,819,518,10,'01_04_02.c3d',23,EE,L,E,2,Same,36
1232,2635,1403,0.470945484,0.553637791,588,1179,32,315,'01_04_03.c3d',23,EE,L,E,3,Same,591
1220,2461,1241,0.493377839,0.545947806,565,1377,273,1,'01_04_04.c3d',23,EE,L,E,4,Same,812
1218,4382,3164,0.358743865,0.506885078,1144,2238,35,1,'01_04_05.c3d',23,EE,L,E,5,Same,1094
1024,1027,3,1.394482759,2.134705356,525,562,363,375,'01_04_01.c3d',24,EE,L,E,1,Same,37
874,1028,154,1.229384773,1.647784753,428,507,247,272,'01_04_02.c3d',24,EE,L,E,2,Same,79
868,1209,341,1.204183908,1.975967529,457,514,288,292,'01_04_03.c3d',24,EE,L,E,3,Same,57
482,1154,672,0.980420023,1.263203488,396,389,63,58,'01_04_04.c3d',24,EE,L,E,4,Same,7
578,956,378,0.696688414,1.175954532,393,476,92,116,'01_04_05.c3d',24,EE,L,E,5,Same,83
816,944,128,0.788628254,1.285380946,525,518,289,51,'01_04_01.c3d',25,EE,L,E,1,Same,7
600,997,397,1.037460071,1.329715108,447,477,259,263,'01_04_02.c3d',25,EE,L,E,2,Same,30
319,1179,860,1.044333804,0.775972708,312,412,1,1,'01_04_03.c3d',25,EE,L,E,3,Same,100
614,942,328,0.884144434,1.327810904,400,447,22,237,'01_04_04.c3d',25,EE,L,E,4,Same,47
699,1021,322,0.830618565,1.321492973,496,573,266,260,'01_04_05.c3d',25,EE,L,E,5,Same,77
1631,1743,112,0.577687499,0.986538262,599,591,1,1,'01_04_01.c3d',26,EE,L,E,1,Same,8
638,3035,2397,0.721600935,1.272440421,459,629,238,98,'01_04_02.c3d',26,EE,L,E,2,Same,170
1230,1554,324,0.708082951,1.491206625,488,621,242,335,'01_04_03.c3d',26,EE,L,E,3,Same,133
616,1348,732,0.846138412,0.924936453,540,528,83,255,'01_04_04.c3d',26,EE,L,E,4,Same,12
503,2479,1976,0.979770198,1.259528123,444,465,60,1,'01_04_05.c3d',26,EE,L,E,5,Same,21
724,1226,502,1.328983862,2.270100307,660,700,49,449,'01_04_01.c3d',27,EE,L,E,1,Same,40
964,1263,299,0.995626631,1.897797941,750,827,568,1,'01_04_02.c3d',27,EE,L,E,2,Same,77
673,1141,468,1.210196902,1.919489119,526,581,339,321,'01_04_03.c3d',27,EE,L,E,3,Same,55
873,1429,556,0.87621092,0.942679679,675,759,437,442,'01_04_04.c3d',27,EE,L,E,4,Same,84
955,1466,511,0.760638885,0.935689797,573,994,28,1,'01_04_05.c3d',27,EE,L,E,5,Same,421
765,1726,961,0.795606461,0.924273232,556,1097,319,1,'01_04_01.c3d',28,EE,L,E,1,Same,541
890,1252,362,0.799179957,0.977910633,462,787,20,331,'01_04_02.c3d',28,EE,L,E,2,Same,325
689,1559,870,0.909763166,1.318698155,515,530,284,288,'01_04_03.c3d',28,EE,L,E,3,Same,15
1893,2454,561,0.539369964,0.901697415,1416,1485,1,1,'01_04_04.c3d',28,EE,L,E,4,Same,69
1003,1363,360,0.508931096,0.761237945,439,765,1,267,'01_04_05.c3d',28,EE,L,E,5,Same,326
491,718,227,1.504593942,2.269199952,446,508,262,281,'01_04_01.c3d',29,EE,L,E,1,Same,62
506,693,187,1.172005402,1.758059826,422,490,239,266,'01_04_02.c3d',29,EE,L,E,2,Same,68
549,832,283,1.290479964,1.797266738,515,521,301,291,'01_04_03.c3d',29,EE,L,E,3,Same,6
595,929,334,0.957868339,1.561165915,514,532,1,282,'01_04_04.c3d',29,EE,L,E,4,Same,18
540,1054,514,0.911981349,1.314256528,419,465,209,1,'01_04_05.c3d',29,EE,L,E,5,Same,46
667,1166,499,1.293470638,1.598277939,599,634,1,441,'01_04_01.c3d',30,EE,L,E,1,Same,35
667,1033,366,1.181053195,1.683471997,607,637,352,418,'01_04_02.c3d',30,EE,L,E,2,Same,30
674,1384,710,0.733581136,1.22171117,455,484,265,1,'01_04_03.c3d',30,EE,L,E,3,Same,29
625,1000,375,0.924041986,1.273745058,500,545,284,62,'01_04_04.c3d',30,EE,L,E,4,Same,45
800,1011,211,0.709960395,0.876203056,416,800,131,216,'01_04_05.c3d',30,EE,L,E,5,Same,384
509,1458,949,2.005061394,2.080111319,440,484,278,269,'01_04_01.c3d',31,EE,L,E,1,Same,44
575,1620,1045,1.573048095,1.763679694,529,544,315,320,'01_04_02.c3d',31,EE,L,E,2,Same,15
1016,1060,44,1.051841726,1.581712821,456,518,84,297,'01_04_03.c3d',31,EE,L,E,3,Same,62
543,1194,651,1.555248939,1.968496983,433,468,241,244,'01_04_04.c3d',31,EE,L,E,4,Same,35
563,1219,656,1.560106038,2.092271648,482,488,299,296,'01_04_05.c3d',31,EE,L,E,5,Same,6
1140,1377,237,1.119671447,1.605538585,739,713,538,1,'01_04_01.c3d',32,EE,L,E,1,Same,26
966,1125,159,0.846945476,1.413290981,521,639,273,289,'01_04_02.c3d',32,EE,L,E,2,Same,118
661,1277,616,0.984655539,1.683751395,577,587,331,1,'01_04_03.c3d',32,EE,L,E,3,Same,10
1007,1604,597,0.755610312,0.935345152,561,583,295,301,'01_04_04.c3d',32,EE,L,E,4,Same,22
903,1238,335,0.797594401,1.304267648,559,539,314,280,'01_04_05.c3d',32,EE,L,E,5,Same,20
908,1518,610,0.726716235,1.222334179,566,564,298,306,'01_04_01.c3d',33,EE,L,E,1,Same,2
981,1253,272,1.068384714,1.57311947,579,564,367,140,'01_04_02.c3d',33,EE,L,E,2,Same,15
913,1503,590,1.081521736,1.179810788,783,805,556,1,'01_04_03.c3d',33,EE,L,E,3,Same,22
727,1140,413,0.868244841,1.375869413,565,553,330,309,'01_04_04.c3d',33,EE,L,E,4,Same,12
883,1384,501,0.707938872,0.797759437,669,671,63,366,'01_04_05.c3d',33,EE,L,E,5,Same,2
717,868,151,0.676107968,1.282305544,509,648,26,328,'01_04_01.c3d',34,EE,L,E,1,Same,139
662,1048,386,0.838941662,1.150112414,505,546,64,308,'01_04_02.c3d',34,EE,L,E,2,Same,41
571,1370,799,1.026521591,1.189603517,494,494,308,296,'01_04_03.c3d',34,EE,L,E,3,Same,0
522,901,379,1.163730927,1.537098945,431,471,273,90,'01_04_04.c3d',34,EE,L,E,4,Same,40
589,987,398,0.837906375,1.547330927,469,488,13,263,'01_04_05.c3d',34,EE,L,E,5,Same,19
475,1351,876,1.448136171,1.837162591,399,439,222,221,'01_04_01.c3d',35,EE,L,E,1,Same,40
463,912,449,1.484065528,1.510257247,386,470,144,186,'01_04_02.c3d',35,EE,L,E,2,Same,84
654,1235,581,0.934510413,1.365901238,517,539,252,256,'01_04_03.c3d',35,EE,L,E,3,Same,22
472,1022,550,1.114817151,1.512478284,396,573,1,1,'01_04_04.c3d',35,EE,L,E,4,Same,177
503,1732,1229,1.234574906,1.478146851,417,541,216,237,'01_04_05.c3d',35,EE,L,E,5,Same,124
816,1386,570,0.665723023,0.83842986,622,1131,1,81,'01_05_01.c3d',1,EE,L,M,1,Same,509
1277,1877,600,0.540497814,1.133529252,420,825,1,259,'01_05_02.c3d',1,EE,L,M,2,Same,405
1114,1238,124,0.699129428,1.013548908,442,621,233,65,'01_05_03.c3d',1,EE,L,M,3,Same,179
877,2337,1460,0.526413364,1.570271196,1097,485,1,239,'01_05_04.c3d',1,EE,L,M,4,Same,612
1389,3767,2378,0.783718688,1.166884839,486,937,290,317,'01_05_05.c3d',1,EE,L,M,5,Same,451
1032,2050,1018,0.725279812,0.733079651,595,2005,344,1,'01_05_01.c3d',2,EE,L,M,1,Same,1410
716,1180,464,0.817738432,1.051173089,548,531,105,1,'01_05_02.c3d',2,EE,L,M,2,Same,17
1091,3388,2297,0.877752877,1.015623497,478,1391,256,266,'01_05_03.c3d',2,EE,L,M,3,Same,913
765,1697,932,0.843655247,0.883736427,513,1304,40,226,'01_05_04.c3d',2,EE,L,M,4,Same,791
746,1249,503,0.634026108,0.988001997,495,461,248,1,'01_05_05.c3d',2,EE,L,M,5,Same,34
478,880,402,1.191652214,1.611275503,411,420,181,34,'01_05_01.c3d',3,EE,L,M,1,Same,9
749,2715,1966,1.472866897,1.681866937,687,694,1,178,'01_05_02.c3d',3,EE,L,M,2,Same,7
692,777,85,1.313747686,1.966221042,394,406,260,146,'01_05_03.c3d',3,EE,L,M,3,Same,12
459,888,429,1.466902556,2.444130989,417,497,240,89,'01_05_04.c3d',3,EE,L,M,4,Same,80
367,777,410,0.985064537,1.006166954,283,387,1,44,'01_05_05.c3d',3,EE,L,M,5,Same,104
797,1189,392,0.812218379,1.330460318,458,841,261,1,'01_05_01.c3d',4,EE,L,M,1,Same,383
841,1027,186,1.328466638,1.339138307,517,531,337,317,'01_05_02.c3d',4,EE,L,M,2,Same,14
722,1063,341,0.996876766,1.125152122,529,506,335,1,'01_05_03.c3d',4,EE,L,M,3,Same,23
907,1020,113,0.881933605,1.193520091,477,504,228,247,'01_05_04.c3d',4,EE,L,M,4,Same,27
625,1090,465,0.855833325,1.047730895,422,847,1,66,'01_05_05.c3d',4,EE,L,M,5,Same,425
581,1073,492,1.995378575,3.011629158,467,484,1,316,'01_05_01.c3d',5,EE,L,M,1,Same,17
833,1121,288,1.723077381,2.897359032,794,814,1,593,'01_05_02.c3d',5,EE,L,M,2,Same,20
590,848,258,2.10872459,2.832789271,413,435,273,257,'01_05_03.c3d',5,EE,L,M,3,Same,22
497,842,345,1.665166657,2.991131756,425,500,277,282,'01_05_04.c3d',5,EE,L,M,4,Same,75
355,779,424,1.731567311,2.030353475,341,434,139,1,'01_05_05.c3d',5,EE,L,M,5,Same,93
713,1494,781,1.123914745,1.619265776,647,1305,1,857,'01_05_01.c3d',6,EE,L,M,1,Same,658
641,1318,677,0.879421466,1.354747977,490,898,1,1,'01_05_02.c3d',6,EE,L,M,2,Same,408
686,1483,797,1.029274136,1.455044645,578,1186,1,399,'01_05_03.c3d',6,EE,L,M,3,Same,608
693,1322,629,0.914164773,1.221706777,508,952,15,118,'01_05_04.c3d',6,EE,L,M,4,Same,444
620,1343,723,0.836491979,1.256230928,492,477,1,1,'01_05_05.c3d',6,EE,L,M,5,Same,15
682,1253,571,0.966296518,1.204771365,575,670,54,1,'01_05_01.c3d',7,EE,L,M,1,Same,95
1026,1120,94,0.928154012,0.899570844,506,567,33,1,'01_05_02.c3d',7,EE,L,M,2,Same,61
822,1005,183,0.779567887,0.933329773,475,562,70,224,'01_05_03.c3d',7,EE,L,M,3,Same,87
589,973,384,1.286117986,1.057878978,420,461,34,1,'01_05_04.c3d',7,EE,L,M,4,Same,41
931,1046,115,0.808269841,1.156847812,385,599,103,48,'01_05_05.c3d',7,EE,L,M,5,Same,214
1612,1635,23,0.727101238,1.015041489,497,575,1,60,'01_05_01.c3d',8,EE,L,M,1,Same,78
968,1567,599,0.830005083,0.960661311,493,525,22,49,'01_05_02.c3d',8,EE,L,M,2,Same,32
810,1486,676,0.704210877,1.041228846,564,621,50,1,'01_05_03.c3d',8,EE,L,M,3,Same,57
980,1283,303,0.692568339,1.138278565,401,425,188,215,'01_05_04.c3d',8,EE,L,M,4,Same,24
1148,2034,886,0.684771707,0.771941947,530,536,309,101,'01_05_05.c3d',8,EE,L,M,5,Same,6
739,807,68,1.289259436,2.325599883,477,468,1,310,'01_05_01.c3d',9,EE,L,M,1,Same,9
893,1456,563,0.791837415,1.349284298,461,416,232,236,'01_05_02.c3d',9,EE,L,M,2,Same,45
1086,1766,680,1.253198127,1.757713337,569,556,1,350,'01_05_03.c3d',9,EE,L,M,3,Same,13
1187,1198,11,0.659063829,0.947580063,648,591,41,53,'01_05_04.c3d',9,EE,L,M,4,Same,57
1033,1433,400,0.888664372,1.369638223,435,403,201,210,'01_05_05.c3d',9,EE,L,M,5,Same,32
755,2132,1377,0.70113999,2.479646561,464,532,271,290,'01_05_01.c3d',10,EE,L,M,1,Same,68
892,1822,930,0.732037859,2.260435153,566,493,46,305,'01_05_02.c3d',10,EE,L,M,2,Same,73
756,929,173,0.695778593,1.888598352,445,450,46,246,'01_05_03.c3d',10,EE,L,M,3,Same,5
916,924,8,1.106703343,2.024694067,574,599,350,1,'01_05_04.c3d',10,EE,L,M,4,Same,25
847,1392,545,1.05490059,1.30357905,288,435,32,38,'01_05_05.c3d',10,EE,L,M,5,Same,147
1101,2062,961,0.509630741,0.662735971,684,715,88,1,'01_05_01.c3d',11,EE,L,M,1,Same,31
1026,2033,1007,0.561910071,0.724272444,966,1020,28,1,'01_05_02.c3d',11,EE,L,M,2,Same,54
1126,1539,413,0.329049825,0.643304699,602,1142,1,1,'01_05_03.c3d',11,EE,L,M,3,Same,540
1001,1609,608,0.481298581,0.688786667,983,620,78,1,'01_05_04.c3d',11,EE,L,M,4,Same,363
1194,2264,1070,0.495059816,0.663672049,625,639,1,1,'01_05_05.c3d',11,EE,L,M,5,Same,14
534,1012,478,1.230719743,1.619420144,446,540,281,282,'01_05_01.c3d',12,EE,L,M,1,Same,94
931,1055,124,0.943836649,1.263788117,526,608,347,358,'01_05_02.c3d',12,EE,L,M,2,Same,82
918,960,42,0.936590047,1.273834948,499,495,317,302,'01_05_03.c3d',12,EE,L,M,3,Same,4
478,918,440,1.323079676,1.543947489,418,452,235,252,'01_05_04.c3d',12,EE,L,M,4,Same,34
544,1012,468,1.178882445,1.617548795,420,494,271,1,'01_05_05.c3d',12,EE,L,M,5,Same,74
547,1003,456,1.052339321,1.541990915,449,476,179,1,'01_05_01.c3d',13,EE,L,M,1,Same,27
878,1041,163,0.943364942,1.469833526,431,488,32,36,'01_05_02.c3d',13,EE,L,M,2,Same,57
877,1126,249,0.947894327,1.526588314,493,581,158,52,'01_05_03.c3d',13,EE,L,M,3,Same,88
681,1161,480,1.212509744,1.591918747,593,625,381,383,'01_05_04.c3d',13,EE,L,M,4,Same,32
539,1336,797,1.141790552,1.161847916,441,508,221,212,'01_05_05.c3d',13,EE,L,M,5,Same,67
449,1007,558,1.907165299,2.796084159,404,461,1,261,'01_05_01.c3d',14,EE,L,M,1,Same,57
461,1228,767,1.545393911,3.279024596,381,422,161,1,'01_05_02.c3d',14,EE,L,M,2,Same,41
348,556,208,0.894006249,1.653790339,260,364,1,1,'01_05_03.c3d',14,EE,L,M,3,Same,104
720,925,205,0.992053199,2.383078506,450,793,63,302,'01_05_04.c3d',14,EE,L,M,4,Same,343
649,718,69,1.251809277,1.973246323,352,454,1,66,'01_05_05.c3d',14,EE,L,M,5,Same,102
754,987,233,1.17347228,2.225188803,441,523,167,128,'01_05_01.c3d',15,EE,L,M,1,Same,82
984,1033,49,1.170960631,1.71242901,466,566,14,192,'01_05_02.c3d',15,EE,L,M,2,Same,100
533,1016,483,1.239316945,2.308452471,430,485,253,266,'01_05_03.c3d',15,EE,L,M,3,Same,55
804,1222,418,0.773740867,1.281299789,539,586,1,1,'01_05_04.c3d',15,EE,L,M,4,Same,47
876,918,42,1.031916585,1.433694083,363,424,1,165,'01_05_05.c3d',15,EE,L,M,5,Same,61
498,1145,647,1.263581785,2.050133443,400,432,219,231,'01_05_01.c3d',16,EE,L,M,1,Same,32
922,1394,472,0.81625302,1.750686604,423,503,1,182,'01_05_02.c3d',16,EE,L,M,2,Same,80
833,1704,871,0.7905465,1.656199919,390,422,12,157,'01_05_03.c3d',16,EE,L,M,3,Same,32
535,931,396,1.189758467,1.892452014,411,453,246,8,'01_05_04.c3d',16,EE,L,M,4,Same,42
837,1659,822,0.674126471,1.618398795,385,429,127,1,'01_05_05.c3d',16,EE,L,M,5,Same,44
594,835,241,1.973848947,2.661440953,428,452,296,306,'01_05_01.c3d',17,EE,L,M,1,Same,24
586,1000,414,1.353105641,2.636119227,475,511,336,154,'01_05_02.c3d',17,EE,L,M,2,Same,36
519,826,307,3.19445155,3.445006098,370,392,269,276,'01_05_03.c3d',17,EE,L,M,3,Same,22
348,729,381,2.392763618,2.492522915,336,345,199,202,'01_05_04.c3d',17,EE,L,M,4,Same,9
919,1213,294,1.120939641,1.386342772,394,424,245,65,'01_05_05.c3d',17,EE,L,M,5,Same,30
570,1359,789,1.457905802,1.623288284,518,547,1,1,'01_05_01.c3d',18,EE,L,M,1,Same,29
492,1028,536,1.403412056,2.116719198,444,498,284,283,'01_05_02.c3d',18,EE,L,M,2,Same,54
561,1019,458,1.037051127,2.018449093,488,516,269,295,'01_05_03.c3d',18,EE,L,M,3,Same,28
620,1008,388,0.986538909,2.023498173,491,553,45,125,'01_05_04.c3d',18,EE,L,M,4,Same,62
566,1163,597,1.041696265,1.783429666,546,484,1,1,'01_05_05.c3d',18,EE,L,M,5,Same,62
833,940,107,0.864516525,1.834520553,458,437,236,256,'01_05_01.c3d',19,EE,L,M,1,Same,21
821,1278,457,0.708470849,1.123183603,474,462,1,259,'01_05_02.c3d',19,EE,L,M,2,Same,12
623,898,275,0.883696372,1.710343005,463,470,69,1,'01_05_03.c3d',19,EE,L,M,3,Same,7
859,1298,439,0.604998584,1.253661082,435,770,163,241,'01_05_04.c3d',19,EE,L,M,4,Same,335
605,984,379,0.806233771,1.288785901,460,544,1,141,'01_05_05.c3d',19,EE,L,M,5,Same,84
646,1056,410,1.069544733,1.982721041,457,514,301,306,'01_05_01.c3d',20,EE,L,M,1,Same,57
527,996,469,1.410910146,1.602082518,431,459,280,265,'01_05_02.c3d',20,EE,L,M,2,Same,28
565,829,264,1.158672249,1.713252958,466,482,66,178,'01_05_03.c3d',20,EE,L,M,3,Same,16
534,870,336,1.379575896,1.730125025,440,468,275,267,'01_05_04.c3d',20,EE,L,M,4,Same,28
819,1046,227,0.785920385,1.225648834,446,504,282,1,'01_05_05.c3d',20,EE,L,M,5,Same,58
520,1029,509,0.906055524,1.032517039,456,469,1,1,'01_05_01.c3d',21,EE,L,M,1,Same,13
563,782,219,0.977461137,1.260878433,439,491,1,70,'01_05_02.c3d',21,EE,L,M,2,Same,52
895,1157,262,0.711444832,0.762846157,438,1062,1,1,'01_05_03.c3d',21,EE,L,M,3,Same,624
854,929,75,0.678764468,1.131770552,448,840,87,81,'01_05_04.c3d',21,EE,L,M,4,Same,392
749,1443,694,0.911193374,0.792604945,455,500,1,272,'01_05_05.c3d',21,EE,L,M,5,Same,45
786,1412,626,1.082980643,1.213741642,464,1026,259,1,'01_05_01.c3d',22,EE,L,M,1,Same,562
580,1157,577,1.252177998,1.598886938,466,823,278,334,'01_05_02.c3d',22,EE,L,M,2,Same,357
783,1853,1070,0.918492973,1.263356587,497,652,285,388,'01_05_03.c3d',22,EE,L,M,3,Same,155
962,1280,318,0.676991995,1.354463862,515,655,71,307,'01_05_04.c3d',22,EE,L,M,4,Same,140
960,1536,576,0.863219666,1.106502254,560,700,319,1,'01_05_05.c3d',22,EE,L,M,5,Same,140
957,2447,1490,0.593560324,1.353973974,963,1624,164,384,'01_05_01.c3d',23,EE,L,M,1,Same,661
994,3049,2055,0.49108447,0.882039856,786,1733,1,313,'01_05_02.c3d',23,EE,L,M,2,Same,947
1147,2116,969,0.364549583,0.622183274,619,525,23,337,'01_05_03.c3d',23,EE,L,M,3,Same,94
1064,3045,1981,0.492292905,0.642757209,679,906,348,67,'01_05_04.c3d',23,EE,L,M,4,Same,227
1670,3084,1414,0.481527792,0.559579887,791,1701,34,269,'01_05_05.c3d',23,EE,L,M,5,Same,910
721,955,234,1.05629891,1.857513219,474,559,21,330,'01_05_01.c3d',24,EE,L,M,1,Same,85
588,988,400,0.866120623,1.438996357,402,455,49,62,'01_05_02.c3d',24,EE,L,M,2,Same,53
760,1429,669,1.066446002,1.293133838,385,447,203,217,'01_05_03.c3d',24,EE,L,M,3,Same,62
467,1015,548,0.963966626,1.070897857,346,454,77,119,'01_05_04.c3d',24,EE,L,M,4,Same,108
645,1201,556,0.744322993,1.152541507,455,500,34,1,'01_05_05.c3d',24,EE,L,M,5,Same,45
923,1139,216,0.510246762,0.798276424,490,599,21,227,'01_05_01.c3d',25,EE,L,M,1,Same,109
538,1156,618,1.295232874,1.612171955,485,490,267,262,'01_05_02.c3d',25,EE,L,M,2,Same,5
1056,1517,461,0.564631624,0.865719088,561,586,246,291,'01_05_03.c3d',25,EE,L,M,3,Same,25
611,1005,394,0.992788284,1.285792881,470,449,248,1,'01_05_04.c3d',25,EE,L,M,4,Same,21
603,1114,511,0.839001214,1.328680705,633,611,245,256,'01_05_05.c3d',25,EE,L,M,5,Same,22
2101,2161,60,0.592214454,1.317635432,1689,1282,172,1,'01_05_01.c3d',26,EE,L,M,1,Same,407
964,1144,180,0.451961319,1.13865545,466,497,1,1,'01_05_02.c3d',26,EE,L,M,2,Same,31
1022,1062,40,0.745465089,0.896628358,468,518,141,212,'01_05_03.c3d',26,EE,L,M,3,Same,50
667,3131,2464,0.85764217,1.424024106,556,635,362,97,'01_05_04.c3d',26,EE,L,M,4,Same,79
1697,2167,470,0.381270624,0.638966468,490,431,1,1,'01_05_05.c3d',26,EE,L,M,5,Same,59
1135,1799,664,0.729203718,0.854670432,682,981,1,327,'01_05_01.c3d',27,EE,L,M,1,Same,299
813,1239,426,0.875706021,1.561408345,625,657,3,367,'01_05_02.c3d',27,EE,L,M,2,Same,32
1032,1257,225,0.768883017,1.162043552,704,685,28,345,'01_05_03.c3d',27,EE,L,M,3,Same,19
1040,1668,628,0.575567845,0.943153698,581,733,15,98,'01_05_04.c3d',27,EE,L,M,4,Same,152
866,1317,451,1.135806778,1.478193353,715,758,25,67,'01_05_05.c3d',27,EE,L,M,5,Same,43
886,2087,1201,0.793283906,0.90280661,581,1578,1,7,'01_05_01.c3d',28,EE,L,M,1,Same,997
910,2247,1337,0.848437708,0.782597994,514,515,1,7,'01_05_02.c3d',28,EE,L,M,2,Same,1
857,1609,752,0.571879101,1.062202878,836,1013,28,382,'01_05_03.c3d',28,EE,L,M,3,Same,177
1825,3342,1517,0.70002488,0.908999041,1256,2447,68,998,'01_05_04.c3d',28,EE,L,M,4,Same,1191
1313,1749,436,0.478609967,0.899416957,533,661,1,1,'01_05_05.c3d',28,EE,L,M,5,Same,128
999,1013,14,1.027028293,1.700595064,491,547,1,359,'01_05_01.c3d',29,EE,L,M,1,Same,56
643,5073,4430,1.349836478,1.873089428,595,663,380,428,'01_05_02.c3d',29,EE,L,M,2,Same,68
526,1099,573,1.209611995,2.350358373,442,483,268,275,'01_05_03.c3d',29,EE,L,M,3,Same,41
544,1430,886,1.042748923,1.836825435,461,525,1,99,'01_05_04.c3d',29,EE,L,M,4,Same,64
503,1110,607,0.858918255,0.962689686,411,455,74,1,'01_05_05.c3d',29,EE,L,M,5,Same,44
628,1045,417,1.149863002,1.478334983,532,560,355,353,'01_05_01.c3d',30,EE,L,M,1,Same,28
603,1058,455,0.814560955,1.212672566,453,508,244,274,'01_05_02.c3d',30,EE,L,M,2,Same,55
618,835,217,0.875351372,1.429987799,478,492,261,275,'01_05_03.c3d',30,EE,L,M,3,Same,14
526,904,378,1.088092761,1.325643441,444,461,10,258,'01_05_04.c3d',30,EE,L,M,4,Same,17
451,974,523,0.691229671,0.868070495,393,445,1,58,'01_05_05.c3d',30,EE,L,M,5,Same,52
1024,1485,461,1.360082704,2.122758447,963,961,309,321,'01_05_01.c3d',31,EE,L,M,1,Same,2
937,1423,486,1.519321639,1.788638375,868,880,670,668,'01_05_02.c3d',31,EE,L,M,2,Same,12
935,1139,204,1.246588657,2.037326242,439,499,277,286,'01_05_03.c3d',31,EE,L,M,3,Same,60
564,1468,904,1.624097969,1.78207144,481,490,295,306,'01_05_04.c3d',31,EE,L,M,4,Same,9
906,1003,97,1.292437819,1.734394278,462,532,296,285,'01_05_05.c3d',31,EE,L,M,5,Same,70
676,830,154,0.986077304,1.59871294,497,510,304,301,'01_05_01.c3d',32,EE,L,M,1,Same,13
629,850,221,1.032039528,1.339197131,486,503,90,268,'01_05_02.c3d',32,EE,L,M,2,Same,17
631,1440,809,0.932985074,1.685257086,503,512,288,292,'01_05_03.c3d',32,EE,L,M,3,Same,9
659,764,105,0.921471366,1.628543294,493,498,275,1,'01_05_04.c3d',32,EE,L,M,4,Same,5
993,1164,171,0.620526513,1.038930871,545,624,1,134,'01_05_05.c3d',32,EE,L,M,5,Same,79
1028,1863,835,0.554387347,0.891620113,533,524,74,153,'01_05_01.c3d',33,EE,L,M,1,Same,9
1085,1152,67,0.788030724,1.537693289,671,551,1,57,'01_05_02.c3d',33,EE,L,M,2,Same,120
950,1231,281,0.886786092,1.113977291,522,566,1,303,'01_05_03.c3d',33,EE,L,M,3,Same,44
1060,1721,661,0.614070414,1.180207902,593,545,1,80,'01_05_04.c3d',33,EE,L,M,4,Same,48
969,1435,466,0.766665359,1.224925671,590,628,384,17,'01_05_05.c3d',33,EE,L,M,5,Same,38
1081,1530,449,0.625583362,1.146568612,811,756,1,435,'01_05_01.c3d',34,EE,L,M,1,Same,55
830,927,97,1.068982,1.84645561,760,828,43,360,'01_05_02.c3d',34,EE,L,M,2,Same,68
868,1207,339,1.000258269,1.604137822,549,542,3,358,'01_05_03.c3d',34,EE,L,M,3,Same,7
528,781,253,1.082254795,1.534649661,413,412,239,232,'01_05_04.c3d',34,EE,L,M,4,Same,1
546,901,355,1.003953585,1.481083276,437,459,258,252,'01_05_05.c3d',34,EE,L,M,5,Same,22
584,1024,440,1.277569987,1.744353244,460,530,282,8,'01_05_01.c3d',35,EE,L,M,1,Same,70
900,968,68,1.093429992,1.712141713,432,486,259,5,'01_05_02.c3d',35,EE,L,M,2,Same,54
484,885,401,1.411099496,1.748065198,394,405,141,1,'01_05_03.c3d',35,EE,L,M,3,Same,11
789,846,57,0.725337482,1.528704359,304,461,1,44,'01_05_04.c3d',35,EE,L,M,4,Same,157
496,1136,640,1.175642437,1.545990367,400,426,205,61,'01_05_05.c3d',35,EE,L,M,5,Same,26
1447,1932,485,0.717965292,0.762496689,526,574,1,326,'01_06_01.c3d',1,EE,L,H,1,Same,48
777,1456,679,1.080458143,1.475189983,633,650,313,19,'01_06_02.c3d',1,EE,L,H,2,Same,17
939,1084,145,0.610815005,1.409189053,448,562,1,294,'01_06_03.c3d',1,EE,L,H,3,Same,114
755,1448,693,0.561083899,0.987258049,585,606,131,1,'01_06_04.c3d',1,EE,L,H,4,Same,21
818,2175,1357,0.872369346,1.490975171,373,459,145,48,'01_06_05.c3d',1,EE,L,H,5,Same,86
1557,1786,229,0.836395273,1.075810138,555,560,1,379,'01_06_01.c3d',2,EE,L,H,1,Same,5
1150,1955,805,0.497206596,0.843093005,475,912,1,47,'01_06_02.c3d',2,EE,L,H,2,Same,437
1120,1918,798,0.669665525,0.982538468,558,1355,283,1,'01_06_03.c3d',2,EE,L,H,3,Same,797
771,1405,634,0.847328143,0.955731667,570,981,194,329,'01_06_04.c3d',2,EE,L,H,4,Same,411
783,2342,1559,0.850576275,0.999808552,464,506,1,13,'01_06_05.c3d',2,EE,L,H,5,Same,42
734,772,38,1.257018707,1.743008578,384,698,1,1,'01_06_01.c3d',3,EE,L,H,1,Same,314
459,993,534,1.333100901,1.592851736,392,438,1,238,'01_06_02.c3d',3,EE,L,H,2,Same,46
458,1161,703,1.104730758,1.402564541,362,731,1,50,'01_06_03.c3d',3,EE,L,H,3,Same,369
446,673,227,1.165661691,1.714263141,386,559,1,221,'01_06_04.c3d',3,EE,L,H,4,Same,173
852,917,65,1.012809494,1.656891713,533,724,1,1,'01_06_05.c3d',3,EE,L,H,5,Same,191
602,1049,447,1.186069717,1.399697806,505,526,1,336,'01_06_01.c3d',4,EE,L,H,1,Same,21
990,1269,279,1.151462797,1.569848171,596,652,1,1,'01_06_02.c3d',4,EE,L,H,2,Same,56
749,898,149,1.070935237,1.59550793,453,472,1,274,'01_06_03.c3d',4,EE,L,H,3,Same,19
694,915,221,0.829312564,1.231428562,510,502,275,149,'01_06_04.c3d',4,EE,L,H,4,Same,8
705,911,206,0.66733594,1.012985008,431,458,1,60,'01_06_05.c3d',4,EE,L,H,5,Same,27
947,973,26,1.243540363,2.102328602,589,613,1,1,'01_06_01.c3d',5,EE,L,H,1,Same,24
469,796,327,1.887138045,2.761746516,417,448,19,281,'01_06_02.c3d',5,EE,L,H,2,Same,31
345,893,548,2.045965579,2.043319094,323,365,179,131,'01_06_03.c3d',5,EE,L,H,3,Same,42
430,834,404,1.92976577,2.336575527,374,400,226,240,'01_06_04.c3d',5,EE,L,H,4,Same,26
647,1055,408,2.00443321,2.289880865,597,613,58,1,'01_06_05.c3d',5,EE,L,H,5,Same,16
701,1651,950,1.103170878,1.486992519,566,1223,1,1,'01_06_01.c3d',6,EE,L,H,1,Same,657
950,1703,753,0.814639957,1.583464604,504,1249,1,28,'01_06_02.c3d',6,EE,L,H,2,Same,745
616,1224,608,0.886432209,1.011836679,466,843,1,1,'01_06_03.c3d',6,EE,L,H,3,Same,377
581,1204,623,1.049953821,1.317874495,460,468,1,263,'01_06_04.c3d',6,EE,L,H,4,Same,8
635,1279,644,0.913603344,1.226671386,480,472,294,1,'01_06_05.c3d',6,EE,L,H,5,Same,8
992,1022,30,0.841200746,0.986930728,486,532,1,1,'01_06_01.c3d',7,EE,L,H,1,Same,46
677,1199,522,0.812237341,0.841475769,499,590,100,1,'01_06_02.c3d',7,EE,L,H,2,Same,91
517,1127,610,0.938170656,0.814406816,366,494,107,178,'01_06_03.c3d',7,EE,L,H,3,Same,128
523,729,206,0.941588756,1.540229745,369,431,161,149,'01_06_04.c3d',7,EE,L,H,4,Same,62
576,882,306,1.080825262,1.268007389,447,474,273,51,'01_06_05.c3d',7,EE,L,H,5,Same,27
716,1594,878,0.690714803,1.196639409,487,479,50,1,'01_06_01.c3d',8,EE,L,H,1,Same,8
1166,1463,297,0.781231285,1.237631234,645,665,1,458,'01_06_02.c3d',8,EE,L,H,2,Same,20
724,1188,464,0.701137377,1.089004889,470,640,276,43,'01_06_03.c3d',8,EE,L,H,3,Same,170
1429,2181,752,0.470239206,0.960169612,571,657,31,25,'01_06_04.c3d',8,EE,L,H,4,Same,86
949,2056,1107,0.617876584,0.872987653,382,435,17,37,'01_06_05.c3d',8,EE,L,H,5,Same,53
626,1606,980,1.113547947,1.948409284,427,421,252,244,'01_06_01.c3d',9,EE,L,H,1,Same,6
885,1768,883,0.940748759,1.714851364,409,397,67,223,'01_06_02.c3d',9,EE,L,H,2,Same,12
583,1078,495,1.395505842,1.838012603,387,410,235,1,'01_06_03.c3d',9,EE,L,H,3,Same,23
951,1829,878,0.307207252,1.220598874,1520,443,16,118,'01_06_04.c3d',9,EE,L,H,4,Same,1077
1073,1809,736,0.930983147,1.295884082,478,452,277,269,'01_06_05.c3d',9,EE,L,H,5,Same,26
1420,2975,1555,1.055441431,3.196114014,852,903,629,692,'01_06_01.c3d',10,EE,L,H,1,Same,51
1057,1615,558,0.58586028,1.903259541,447,487,1,281,'01_06_02.c3d',10,EE,L,H,2,Same,40
838,1192,354,0.798821039,1.874137154,402,439,238,254,'01_06_03.c3d',10,EE,L,H,3,Same,37
875,1010,135,0.81342162,1.913417467,375,425,55,209,'01_06_04.c3d',10,EE,L,H,4,Same,50
539,906,367,1.774611071,3.380200993,388,408,269,260,'01_06_05.c3d',10,EE,L,H,5,Same,20
685,1555,870,1.037748558,1.248803625,527,555,336,1,'01_06_01.c3d',11,EE,L,H,1,Same,28
869,1500,631,0.537160518,0.878848553,551,542,294,296,'01_06_02.c3d',11,EE,L,H,2,Same,9
1114,1765,651,0.559440657,0.866252044,687,728,1,154,'01_06_03.c3d',11,EE,L,H,3,Same,41
1056,1882,826,0.486641096,0.54237715,630,611,1,1,'01_06_04.c3d',11,EE,L,H,4,Same,19
994,1620,626,0.636418291,0.76891136,572,629,1,27,'01_06_05.c3d',11,EE,L,H,5,Same,57
509,893,384,1.225026198,1.313709461,409,436,35,1,'01_06_01.c3d',12,EE,L,H,1,Same,27
1071,1580,509,1.095116062,1.213846232,514,574,344,350,'01_06_02.c3d',12,EE,L,H,2,Same,60
437,1145,708,1.704413726,2.220970345,397,444,1,271,'01_06_03.c3d',12,EE,L,H,3,Same,47
484,844,360,1.194513811,1.443118974,391,493,102,245,'01_06_04.c3d',12,EE,L,H,4,Same,102
487,1297,810,0.909695272,0.850022528,373,464,1,100,'01_06_05.c3d',12,EE,L,H,5,Same,91
669,1102,433,1.102303728,1.333492669,558,615,1,1,'01_06_01.c3d',13,EE,L,H,1,Same,57
580,963,383,1.025248269,1.523488189,462,505,188,1,'01_06_02.c3d',13,EE,L,H,2,Same,43
607,1029,422,0.942656523,2.178817657,497,537,1,37,'01_06_03.c3d',13,EE,L,H,3,Same,40
785,1204,419,0.882122178,1.435821034,397,468,1,249,'01_06_04.c3d',13,EE,L,H,4,Same,71
768,983,215,0.988694262,1.531514754,414,481,243,269,'01_06_05.c3d',13,EE,L,H,5,Same,67
486,851,365,1.481072837,1.953407027,395,474,215,274,'01_06_01.c3d',14,EE,L,H,1,Same,79
754,791,37,1.294414933,2.280158306,381,461,1,261,'01_06_02.c3d',14,EE,L,H,2,Same,80
462,869,407,1.682856073,2.312663697,360,462,216,268,'01_06_03.c3d',14,EE,L,H,3,Same,102
470,823,353,1.18521263,2.027443475,396,466,52,125,'01_06_04.c3d',14,EE,L,H,4,Same,70
743,869,126,1.108355937,1.590140367,313,488,1,154,'01_06_05.c3d',14,EE,L,H,5,Same,175
1049,1065,16,0.751473911,1.541873613,547,702,1,1,'01_06_01.c3d',15,EE,L,H,1,Same,155
825,971,146,0.651927647,1.411751964,802,531,350,1,'01_06_02.c3d',15,EE,L,H,2,Same,271
727,867,140,0.878337856,1.672924753,405,434,51,1,'01_06_03.c3d',15,EE,L,H,3,Same,29
449,1065,616,1.114543225,1.578206348,354,419,78,19,'01_06_04.c3d',15,EE,L,H,4,Same,65
749,812,63,1.163054852,1.626035778,413,474,169,210,'01_06_05.c3d',15,EE,L,H,5,Same,61
575,1558,983,1.421530711,2.274534141,482,561,1,1,'01_06_01.c3d',16,EE,L,H,1,Same,79
988,1386,398,0.878501281,1.741481958,483,493,324,39,'01_06_02.c3d',16,EE,L,H,2,Same,10
861,1163,302,1.062499926,1.435023376,396,451,75,67,'01_06_03.c3d',16,EE,L,H,3,Same,55
711,1176,465,1.182868109,1.834203453,424,446,250,1,'01_06_04.c3d',16,EE,L,H,4,Same,22
848,891,43,0.687645982,1.642896655,352,459,1,218,'01_06_05.c3d',16,EE,L,H,5,Same,107
543,911,368,1.540576038,2.629192359,444,474,1,322,'01_06_01.c3d',17,EE,L,H,1,Same,30
512,989,477,2.201598272,2.12688567,397,413,274,283,'01_06_02.c3d',17,EE,L,H,2,Same,16
529,885,356,2.367403164,3.31994082,408,426,304,90,'01_06_03.c3d',17,EE,L,H,3,Same,18
408,815,407,2.034197177,2.369782986,364,394,247,49,'01_06_04.c3d',17,EE,L,H,4,Same,30
376,713,337,2.027215952,3.322593801,336,388,229,237,'01_06_05.c3d',17,EE,L,H,5,Same,52
548,733,185,1.235334618,2.0742321,448,526,1,1,'01_06_01.c3d',18,EE,L,H,1,Same,78
436,881,445,1.614483042,2.001013953,401,444,1,32,'01_06_02.c3d',18,EE,L,H,2,Same,43
197,1036,839,1.504621959,1.381432652,175,283,1,1,'01_06_03.c3d',18,EE,L,H,3,Same,108
565,1756,1191,1.336729277,2.69386466,482,568,1,36,'01_06_04.c3d',18,EE,L,H,4,Same,86
375,863,488,0.942613829,2.3613579,386,458,1,26,'01_06_05.c3d',18,EE,L,H,5,Same,72
821,928,107,0.854281614,1.072133091,454,482,1,257,'01_06_01.c3d',19,EE,L,H,1,Same,28
894,1144,250,0.969599943,1.273435772,428,446,250,71,'01_06_02.c3d',19,EE,L,H,2,Same,18
809,1076,267,0.662539617,1.252762132,455,444,1,1,'01_06_03.c3d',19,EE,L,H,3,Same,11
1028,1047,19,0.652751957,1.337349492,576,663,1,41,'01_06_04.c3d',19,EE,L,H,4,Same,87
934,1146,212,0.981857667,1.240718542,507,457,1,98,'01_06_05.c3d',19,EE,L,H,5,Same,50
646,1280,634,1.068461538,1.568040797,504,537,47,282,'01_06_01.c3d',20,EE,L,H,1,Same,33
833,1273,440,1.069129822,1.551664668,492,515,110,337,'01_06_02.c3d',20,EE,L,H,2,Same,23
624,889,265,1.058068519,1.938891529,474,496,285,296,'01_06_03.c3d',20,EE,L,H,3,Same,22
817,1011,194,0.836283084,1.41831187,433,517,284,259,'01_06_04.c3d',20,EE,L,H,4,Same,84
1171,1499,328,0.946796829,1.279347086,469,507,285,253,'01_06_05.c3d',20,EE,L,H,5,Same,38
1908,2061,153,0.545534711,0.794707316,761,800,1,1,'01_06_01.c3d',21,EE,L,H,1,Same,39
647,4737,4090,1.017492919,1.039358361,487,522,1,295,'01_06_02.c3d',21,EE,L,H,2,Same,35
904,1135,231,1.020239273,1.146453021,449,504,42,265,'01_06_03.c3d',21,EE,L,H,3,Same,55
677,1130,453,0.93383704,1.340127073,474,502,291,296,'01_06_04.c3d',21,EE,L,H,4,Same,28
774,1186,412,0.974984709,0.88902775,402,479,1,1,'01_06_05.c3d',21,EE,L,H,5,Same,77
573,1323,750,1.371553766,1.551343936,450,777,283,482,'01_06_01.c3d',22,EE,L,H,1,Same,327
718,1581,863,1.044769343,1.027088489,460,507,1,13,'01_06_02.c3d',22,EE,L,H,2,Same,47
961,1829,868,0.768823263,0.872907466,618,664,372,21,'01_06_03.c3d',22,EE,L,H,3,Same,46
912,1844,932,0.749199264,0.878737744,559,1390,1,58,'01_06_04.c3d',22,EE,L,H,4,Same,831
951,2124,1173,0.770103585,0.750135866,538,1423,333,446,'01_06_05.c3d',22,EE,L,H,5,Same,885
5232,12200,6968,0.255912186,0.868258507,908,3252,1,695,'01_06_01.c3d',23,EE,L,H,1,Same,2344
978,2421,1443,0.648577333,0.82639778,467,520,273,1,'01_06_02.c3d',23,EE,L,H,2,Same,53
1023,5537,4514,0.535475095,1.656156665,944,2624,1,435,'01_06_03.c3d',23,EE,L,H,3,Same,1680
1311,3073,1762,0.330882082,0.587857854,531,1386,23,39,'01_06_04.c3d',23,EE,L,H,4,Same,855
2847,3759,912,0.234916364,0.719842306,891,1799,10,69,'01_06_05.c3d',23,EE,L,H,5,Same,908
728,811,83,0.92000809,1.751274462,393,427,227,244,'01_06_01.c3d',24,EE,L,H,1,Same,34
766,1060,294,1.037730759,1.596578723,426,472,240,253,'01_06_02.c3d',24,EE,L,H,2,Same,46
816,934,118,0.914761606,1.753975859,413,462,237,240,'01_06_03.c3d',24,EE,L,H,3,Same,49
729,928,199,1.081881741,1.686165706,453,523,282,54,'01_06_04.c3d',24,EE,L,H,4,Same,70
620,1019,399,0.923487393,1.600236309,416,478,226,1,'01_06_05.c3d',24,EE,L,H,5,Same,62
562,981,419,1.027511105,1.507783616,474,548,1,269,'01_06_01.c3d',25,EE,L,H,1,Same,74
734,1127,393,0.664332203,1.132364587,625,602,69,313,'01_06_02.c3d',25,EE,L,H,2,Same,23
751,1180,429,0.81683714,1.16875111,514,542,260,45,'01_06_03.c3d',25,EE,L,H,3,Same,28
871,1186,315,0.735897061,0.945769952,442,492,251,68,'01_06_04.c3d',25,EE,L,H,4,Same,50
675,968,293,1.020033595,1.103426044,430,457,244,251,'01_06_05.c3d',25,EE,L,H,5,Same,27
510,1727,1217,1.249733377,1.269976626,433,857,261,7,'01_06_01.c3d',26,EE,L,H,1,Same,424
1260,1282,22,0.759500148,1.583534974,438,495,1,275,'01_06_02.c3d',26,EE,L,H,2,Same,57
1326,1511,185,0.651906768,1.889189999,556,512,69,308,'01_06_03.c3d',26,EE,L,H,3,Same,44
522,1411,889,0.989855957,1.380949883,436,471,25,258,'01_06_04.c3d',26,EE,L,H,4,Same,35
1291,1681,390,0.747053275,1.072908395,452,831,246,214,'01_06_05.c3d',26,EE,L,H,5,Same,379
1097,1432,335,0.73816706,1.308000877,589,610,339,335,'01_06_01.c3d',27,EE,L,H,1,Same,21
1113,1619,506,0.81170679,0.96914998,728,790,1,1,'01_06_02.c3d',27,EE,L,H,2,Same,62
1049,1437,388,0.846605666,1.037951506,689,702,1,1,'01_06_03.c3d',27,EE,L,H,3,Same,13
1241,1774,533,0.850292524,1.025162067,580,938,379,26,'01_06_04.c3d',27,EE,L,H,4,Same,358
826,1207,381,0.718746856,0.983618572,488,556,1,261,'01_06_05.c3d',27,EE,L,H,5,Same,68
1227,1958,731,0.545731793,0.828422287,539,911,325,22,'01_06_01.c3d',28,EE,L,H,1,Same,372
904,3887,2983,0.765232846,0.866173809,556,1707,1,1,'01_06_02.c3d',28,EE,L,H,2,Same,1151
984,1769,785,0.709652556,0.695188248,923,1181,323,322,'01_06_03.c3d',28,EE,L,H,3,Same,258
872,2857,1985,0.636292838,0.914393854,514,542,65,271,'01_06_04.c3d',28,EE,L,H,4,Same,28
862,1090,228,0.69210089,1.056075098,885,876,227,78,'01_06_05.c3d',28,EE,L,H,5,Same,9
561,1741,1180,1.592206092,2.16694873,526,568,1,357,'01_06_01.c3d',29,EE,L,H,1,Same,42
480,1281,801,1.25047025,1.744743099,396,415,60,1,'01_06_02.c3d',29,EE,L,H,2,Same,19
485,1014,529,1.10345471,1.300083437,415,560,54,221,'01_06_03.c3d',29,EE,L,H,3,Same,145
1206,1609,403,0.616252061,0.968847128,617,649,394,182,'01_06_04.c3d',29,EE,L,H,4,Same,32
973,1335,362,0.874740154,1.26394442,523,570,321,352,'01_06_05.c3d',29,EE,L,H,5,Same,47
966,1093,127,0.978106054,1.632060987,561,593,17,415,'01_06_01.c3d',30,EE,L,H,1,Same,32
518,999,481,1.230678601,1.770140608,431,445,1,1,'01_06_02.c3d',30,EE,L,H,2,Same,14
821,1109,288,0.832734666,1.088969953,457,472,1,31,'01_06_03.c3d',30,EE,L,H,3,Same,15
905,1323,418,0.592324261,0.827394378,453,684,141,272,'01_06_04.c3d',30,EE,L,H,4,Same,231
981,1026,45,0.708225188,1.32874975,461,464,1,12,'01_06_05.c3d',30,EE,L,H,5,Same,3
631,1315,684,1.644686215,2.260291765,525,529,370,375,'01_06_01.c3d',31,EE,L,H,1,Same,4
686,1012,326,1.420033891,2.284668179,506,527,329,321,'01_06_02.c3d',31,EE,L,H,2,Same,21
1060,1195,135,1.255301963,1.560271326,515,554,34,345,'01_06_03.c3d',31,EE,L,H,3,Same,39
623,1220,597,1.366236407,1.931746269,463,466,280,292,'01_06_04.c3d',31,EE,L,H,4,Same,3
1082,1221,139,1.154421038,1.722358512,489,508,1,57,'01_06_05.c3d',31,EE,L,H,5,Same,19
584,2186,1602,1.20390947,2.025635568,464,498,289,305,'01_06_01.c3d',32,EE,L,H,1,Same,34
606,1150,544,1.10749672,1.412032381,500,522,294,111,'01_06_02.c3d',32,EE,L,H,2,Same,22
613,1551,938,1.018849937,1.415206052,490,535,258,101,'01_06_03.c3d',32,EE,L,H,3,Same,45
762,792,30,0.88274821,1.345882768,410,698,33,226,'01_06_04.c3d',32,EE,L,H,4,Same,288
998,1118,120,0.698338899,1.133718911,502,690,1,283,'01_06_05.c3d',32,EE,L,H,5,Same,188
1339,2902,1563,0.580237495,0.727367098,703,2311,1,249,'01_06_01.c3d',33,EE,L,H,1,Same,1608
993,1409,416,0.755159988,1.350525972,619,641,33,1,'01_06_02.c3d',33,EE,L,H,2,Same,22
971,1484,513,0.853701287,1.175929572,605,579,384,1,'01_06_03.c3d',33,EE,L,H,3,Same,26
976,1504,528,0.696681692,1.217347475,599,657,33,385,'01_06_04.c3d',33,EE,L,H,4,Same,58
879,1144,265,1.082939563,1.273960978,480,553,305,312,'01_06_05.c3d',33,EE,L,H,5,Same,73
590,1028,438,1.462785547,1.656531489,509,574,363,391,'01_06_01.c3d',34,EE,L,H,1,Same,65
602,1209,607,0.882203364,1.156527692,478,532,1,54,'01_06_02.c3d',34,EE,L,H,2,Same,54
1008,1170,162,0.769675547,0.93850421,472,763,18,298,'01_06_03.c3d',34,EE,L,H,3,Same,291
793,1408,615,0.624405329,1.107342049,530,492,364,325,'01_06_04.c3d',34,EE,L,H,4,Same,38
660,1086,426,0.764752265,1.241855136,413,410,134,200,'01_06_05.c3d',34,EE,L,H,5,Same,3
1221,1312,91,0.948319388,1.046511294,501,916,1,361,'01_06_01.c3d',35,EE,L,H,1,Same,415
472,1221,749,1.483263173,1.593955318,402,443,224,230,'01_06_02.c3d',35,EE,L,H,2,Same,41
523,996,473,1.189214262,2.185908399,429,446,1,225,'01_06_03.c3d',35,EE,L,H,3,Same,17
621,1044,423,1.17047604,1.856470994,488,543,1,301,'01_06_04.c3d',35,EE,L,H,4,Same,55
827,1182,355,0.888144154,1.371233107,383,425,101,197,'01_06_05.c3d',35,EE,L,H,5,Same,42
548,1157,609,1.471097649,1.048522648,573,490,49,67,'01_07_01.c3d',1,EE,R,E,1,Same,83
733,1340,607,1.054433447,0.969257692,558,664,274,1,'01_07_02.c3d',1,EE,R,E,2,Same,106
578,1421,843,1.57843057,1.359977293,529,541,258,7,'01_07_03.c3d',1,EE,R,E,3,Same,12
620,1291,671,1.571582593,1.059790714,612,545,307,288,'01_07_04.c3d',1,EE,R,E,4,Same,67
1293,1378,85,0.975232847,0.933986571,645,555,42,1,'01_07_05.c3d',1,EE,R,E,5,Same,90
624,1365,741,0.976169999,1.088007434,809,492,100,243,'01_07_01.c3d',2,EE,R,E,1,Same,317
1075,1134,59,1.044539629,0.972070208,588,560,33,1,'01_07_02.c3d',2,EE,R,E,2,Same,28
943,1260,317,1.021989173,1.133710649,586,546,378,1,'01_07_03.c3d',2,EE,R,E,3,Same,40
682,1082,400,0.959605576,0.859022217,681,574,49,1,'01_07_04.c3d',2,EE,R,E,4,Same,107
1167,1810,643,0.851539828,0.786814047,536,691,78,1,'01_07_05.c3d',2,EE,R,E,5,Same,155
1400,1474,74,1.097095879,1.307866618,1036,604,1,472,'01_07_01.c3d',3,EE,R,E,1,Same,432
1281,1363,82,1.796632974,1.003187136,835,748,24,1,'01_07_02.c3d',3,EE,R,E,2,Same,87
322,845,523,1.589540732,1.403691407,465,374,48,51,'01_07_03.c3d',3,EE,R,E,3,Same,91
567,921,354,1.60825098,1.626774371,491,456,250,1,'01_07_04.c3d',3,EE,R,E,4,Same,35
636,973,337,1.128185571,1.170999064,641,507,26,22,'01_07_05.c3d',3,EE,R,E,5,Same,134
817,874,57,1.721148045,1.014621048,577,493,332,289,'01_07_01.c3d',4,EE,R,E,1,Same,84
1110,1331,221,2.132341022,1.284778471,638,597,406,1,'01_07_02.c3d',4,EE,R,E,2,Same,41
499,827,328,1.527863099,1.132879739,480,430,250,237,'01_07_03.c3d',4,EE,R,E,3,Same,50
727,1155,428,1.170227297,0.723051409,581,569,292,305,'01_07_04.c3d',4,EE,R,E,4,Same,12
944,980,36,1.20294468,0.759728491,518,534,279,25,'01_07_05.c3d',4,EE,R,E,5,Same,16
631,1741,1110,2.830255264,1.8888641,599,605,458,1,'01_07_01.c3d',5,EE,R,E,1,Same,6
496,973,477,3.363134323,2.300633869,499,488,357,36,'01_07_02.c3d',5,EE,R,E,2,Same,11
140,621,481,1.669979368,2.245471402,201,153,1,1,'01_07_03.c3d',5,EE,R,E,3,Same,48
543,931,388,2.121527427,1.372548995,543,491,339,198,'01_07_04.c3d',5,EE,R,E,4,Same,52
527,1347,820,1.916778948,1.739917931,511,461,66,81,'01_07_05.c3d',5,EE,R,E,5,Same,50
1126,1686,560,0.679318095,0.570388139,1655,724,8,233,'01_07_01.c3d',6,EE,R,E,1,Same,931
838,1793,955,0.804321549,0.94929913,1469,552,1,1,'01_07_02.c3d',6,EE,R,E,2,Same,917
665,1813,1148,1.548617906,1.669226949,1404,623,279,45,'01_07_03.c3d',6,EE,R,E,3,Same,781
693,1443,750,0.828103558,0.888722835,735,607,1,12,'01_07_04.c3d',6,EE,R,E,4,Same,128
648,1242,594,1.46983351,0.961350111,973,520,1,1,'01_07_05.c3d',6,EE,R,E,5,Same,453
633,1611,978,1.535693597,1.077517944,573,534,358,1,'01_07_01.c3d',7,EE,R,E,1,Same,39
687,854,167,1.59227999,0.91487686,533,497,272,26,'01_07_02.c3d',7,EE,R,E,2,Same,36
976,988,12,1.274655367,0.605449309,466,388,244,65,'01_07_03.c3d',7,EE,R,E,3,Same,78
95,1643,1548,1.383986875,0.987472275,539,22,1,1,'01_07_04.c3d',7,EE,R,E,4,Same,517
779,1070,291,1.665469687,0.865066644,494,436,1,1,'01_07_05.c3d',7,EE,R,E,5,Same,58
652,1264,612,1.221678536,0.873682733,459,413,10,87,'01_07_01.c3d',8,EE,R,E,1,Same,46
894,1594,700,0.791816471,0.769786913,594,590,348,50,'01_07_02.c3d',8,EE,R,E,2,Same,4
729,1635,906,0.692625753,0.584257804,482,626,152,1,'01_07_03.c3d',8,EE,R,E,3,Same,144
546,1097,551,0.984823933,0.981214799,438,406,184,1,'01_07_04.c3d',8,EE,R,E,4,Same,32
787,1036,249,1.275854841,0.682680353,457,360,1,119,'01_07_05.c3d',8,EE,R,E,5,Same,97
924,1863,939,0.986422962,1.264806973,698,445,54,287,'01_07_01.c3d',9,EE,R,E,1,Same,253
576,1086,510,1.68044957,1.137276914,463,441,288,175,'01_07_02.c3d',9,EE,R,E,2,Same,22
641,1403,762,1.446819746,1.063981615,472,419,258,1,'01_07_03.c3d',9,EE,R,E,3,Same,53
659,1306,647,1.757559187,1.26363671,456,410,254,251,'01_07_04.c3d',9,EE,R,E,4,Same,46
738,1661,923,0.7712799,1.246897388,1176,450,283,281,'01_07_05.c3d',9,EE,R,E,5,Same,726
590,810,220,2.510672452,1.503667758,589,510,68,1,'01_07_01.c3d',10,EE,R,E,1,Same,79
939,1641,702,1.602323472,0.902966982,485,536,292,1,'01_07_02.c3d',10,EE,R,E,2,Same,51
840,906,66,1.713273347,1.157389432,422,402,248,162,'01_07_03.c3d',10,EE,R,E,3,Same,20
528,922,394,2.174591876,1.520228703,472,472,287,262,'01_07_04.c3d',10,EE,R,E,4,Same,0
1092,1377,285,1.234966418,1.193933302,485,464,48,101,'01_07_05.c3d',10,EE,R,E,5,Same,21
929,2290,1361,1.368174039,0.911309804,773,766,540,15,'01_07_01.c3d',11,EE,R,E,1,Same,7
1360,2330,970,0.624507055,0.571858286,741,716,1,1,'01_07_02.c3d',11,EE,R,E,2,Same,25
1081,1604,523,0.690595146,0.696599804,1604,54,1,1,'01_07_03.c3d',11,EE,R,E,3,Same,1550
1080,2135,1055,0.534221883,0.522289101,676,682,28,1,'01_07_04.c3d',11,EE,R,E,4,Same,6
919,1779,860,0.642912802,0.600672158,640,619,1,1,'01_07_05.c3d',11,EE,R,E,5,Same,21
895,1069,174,1.32104308,0.758366786,534,497,309,39,'01_07_01.c3d',12,EE,R,E,1,Same,37
864,940,76,1.547860902,1.040899815,466,461,281,271,'01_07_02.c3d',12,EE,R,E,2,Same,5
698,1457,759,1.714087151,0.892677999,579,602,365,41,'01_07_03.c3d',12,EE,R,E,3,Same,23
925,1028,103,1.372408989,0.834210686,525,500,329,49,'01_07_04.c3d',12,EE,R,E,4,Same,25
875,1124,249,1.233197049,0.64214441,551,491,292,61,'01_07_05.c3d',12,EE,R,E,5,Same,60
645,968,323,1.825659866,1.081577046,538,519,303,310,'01_07_01.c3d',13,EE,R,E,1,Same,19
570,1263,693,1.520443854,1.069824377,551,444,276,1,'01_07_02.c3d',13,EE,R,E,2,Same,107
610,679,69,1.639712663,1.148534884,438,465,215,1,'01_07_03.c3d',13,EE,R,E,3,Same,27
658,1792,1134,1.595574661,1.303688828,538,472,53,305,'01_07_04.c3d',13,EE,R,E,4,Same,66
555,1123,568,1.33690243,1.066743025,499,469,258,77,'01_07_05.c3d',13,EE,R,E,5,Same,30
678,804,126,2.021611087,1.651188872,527,497,1,141,'01_07_01.c3d',14,EE,R,E,1,Same,30
441,1065,624,2.232802956,2.144959239,423,392,239,223,'01_07_02.c3d',14,EE,R,E,2,Same,31
400,829,429,2.115004554,1.25822038,380,366,36,1,'01_07_03.c3d',14,EE,R,E,3,Same,14
907,1274,367,2.288274262,2.206982728,453,451,281,241,'01_07_04.c3d',14,EE,R,E,4,Same,2
445,979,534,1.923981516,1.474248436,383,399,198,124,'01_07_05.c3d',14,EE,R,E,5,Same,16
474,892,418,1.598648885,1.335255938,471,401,132,132,'01_07_01.c3d',15,EE,R,E,1,Same,70
433,784,351,1.739930906,0.931436163,422,342,123,5,'01_07_02.c3d',15,EE,R,E,2,Same,80
655,956,301,1.58566443,0.899018333,484,507,1,267,'01_07_03.c3d',15,EE,R,E,3,Same,23
653,941,288,1.531725074,0.921488728,444,429,1,49,'01_07_04.c3d',15,EE,R,E,4,Same,15
741,1010,269,1.193050736,0.869041045,460,489,265,52,'01_07_05.c3d',15,EE,R,E,5,Same,29
496,1540,1044,1.820960374,1.43289417,455,399,255,41,'01_07_01.c3d',16,EE,R,E,1,Same,56
615,980,365,1.45381063,1.090948079,548,487,280,1,'01_07_02.c3d',16,EE,R,E,2,Same,61
577,1092,515,1.852279539,0.987701224,601,403,223,37,'01_07_03.c3d',16,EE,R,E,3,Same,198
852,853,1,1.375699225,0.989892842,418,391,209,141,'01_07_04.c3d',16,EE,R,E,4,Same,27
557,1138,581,1.534406223,1.385688011,519,476,317,9,'01_07_05.c3d',16,EE,R,E,5,Same,43
540,1094,554,3.573343749,2.920495499,395,383,259,259,'01_07_01.c3d',17,EE,R,E,1,Same,12
646,753,107,2.371579483,1.856775115,509,460,356,335,'01_07_02.c3d',17,EE,R,E,2,Same,49
655,678,23,2.413597984,1.795186343,424,430,287,284,'01_07_03.c3d',17,EE,R,E,3,Same,6
546,575,29,3.594974596,2.368389376,394,386,261,257,'01_07_04.c3d',17,EE,R,E,4,Same,8
392,778,386,3.494802034,2.434541314,392,365,255,254,'01_07_05.c3d',17,EE,R,E,5,Same,27
569,859,290,1.671483784,1.316882656,441,452,1,274,'01_07_01.c3d',18,EE,R,E,1,Same,11
705,839,134,1.823996472,1.212675035,564,564,354,1,'01_07_02.c3d',18,EE,R,E,2,Same,0
514,999,485,2.372330204,1.942819657,499,500,1,1,'01_07_03.c3d',18,EE,R,E,3,Same,1
557,1336,779,1.833228461,1.604055923,538,511,1,321,'01_07_04.c3d',18,EE,R,E,4,Same,27
491,1086,595,1.471711003,1.777991637,447,479,1,231,'01_07_05.c3d',18,EE,R,E,5,Same,32
944,1519,575,0.89075116,0.952609603,545,491,84,1,'01_07_01.c3d',19,EE,R,E,1,Same,54
648,1038,390,1.150222935,1.036773726,521,471,52,293,'01_07_02.c3d',19,EE,R,E,2,Same,50
753,820,67,1.48605168,1.09816149,448,417,235,222,'01_07_03.c3d',19,EE,R,E,3,Same,31
559,898,339,1.324383697,1.162691416,520,434,281,272,'01_07_04.c3d',19,EE,R,E,4,Same,86
707,1166,459,1.515058533,0.945169512,670,629,1,40,'01_07_05.c3d',19,EE,R,E,5,Same,41
900,1552,652,1.059775044,1.192833367,704,720,1,1,'01_07_01.c3d',20,EE,R,E,1,Same,16
841,1061,220,1.624132309,1.280521817,498,456,275,264,'01_07_02.c3d',20,EE,R,E,2,Same,42
655,1403,748,2.017364604,1.193733038,494,450,304,270,'01_07_03.c3d',20,EE,R,E,3,Same,44
787,3357,2570,1.189257169,0.890341767,476,442,1,46,'01_07_04.c3d',20,EE,R,E,4,Same,34
555,1441,886,1.109098343,1.458601519,480,446,301,258,'01_07_05.c3d',20,EE,R,E,5,Same,34
677,940,263,1.295407608,0.707807852,557,602,306,53,'01_07_01.c3d',21,EE,R,E,1,Same,45
702,836,134,1.130055326,0.807435137,787,479,288,1,'01_07_02.c3d',21,EE,R,E,2,Same,308
911,1365,454,0.713859162,0.691829166,481,460,1,1,'01_07_03.c3d',21,EE,R,E,3,Same,21
710,1321,611,0.736803,0.696262802,526,382,37,46,'01_07_04.c3d',21,EE,R,E,4,Same,144
825,1295,470,0.885869109,0.700082911,520,447,246,1,'01_07_05.c3d',21,EE,R,E,5,Same,73
784,1563,779,0.812157489,1.092331433,1288,627,386,400,'01_07_01.c3d',22,EE,R,E,1,Same,661
844,1251,407,1.053075301,0.974063678,617,593,315,1,'01_07_02.c3d',22,EE,R,E,2,Same,24
1006,1690,684,0.926310495,0.828553667,775,781,413,1,'01_07_03.c3d',22,EE,R,E,3,Same,6
1071,2161,1090,0.988539273,0.85566728,1466,697,87,416,'01_07_04.c3d',22,EE,R,E,4,Same,769
923,1819,896,0.755662743,1.051604273,964,746,479,61,'01_07_05.c3d',22,EE,R,E,5,Same,218
2419,3321,902,0.928416869,0.917941194,863,574,21,1,'01_07_01.c3d',23,EE,R,E,1,Same,289
1133,2090,957,0.584580246,0.690577027,518,518,263,292,'01_07_02.c3d',23,EE,R,E,2,Same,0
1299,1950,651,0.955271405,0.720407147,459,402,251,63,'01_07_03.c3d',23,EE,R,E,3,Same,57
1412,2250,838,0.444717138,0.371020741,1662,1296,2,250,'01_07_04.c3d',23,EE,R,E,4,Same,366
1854,2577,723,0.41740826,0.23762433,2528,508,1,1,'01_07_05.c3d',23,EE,R,E,5,Same,2020
686,916,230,1.679057907,1.147276793,480,419,232,257,'01_07_01.c3d',24,EE,R,E,1,Same,61
603,1310,707,1.668299412,0.89242069,479,379,202,1,'01_07_02.c3d',24,EE,R,E,2,Same,100
628,768,140,1.717710771,0.926202186,512,431,256,121,'01_07_03.c3d',24,EE,R,E,3,Same,81
934,964,30,1.063314452,0.859665644,607,425,199,1,'01_07_04.c3d',24,EE,R,E,4,Same,182
869,1152,283,0.865631465,0.857552366,465,473,38,259,'01_07_05.c3d',24,EE,R,E,5,Same,8
1093,1723,630,0.907366076,0.745889265,563,589,359,349,'01_07_01.c3d',25,EE,R,E,1,Same,26
978,1254,276,1.209558122,0.743262154,627,595,313,282,'01_07_02.c3d',25,EE,R,E,2,Same,32
937,1617,680,1.025036196,0.707714805,605,511,248,254,'01_07_03.c3d',25,EE,R,E,3,Same,94
522,1397,875,1.364983613,1.043531121,510,429,281,161,'01_07_04.c3d',25,EE,R,E,4,Same,81
675,1666,991,0.996734012,0.671436085,539,415,270,223,'01_07_05.c3d',25,EE,R,E,5,Same,124
796,1256,460,1.504167398,1.176205108,626,570,137,1,'01_07_01.c3d',26,EE,R,E,1,Same,56
1158,1200,42,1.001360659,0.67691847,600,554,304,1,'01_07_02.c3d',26,EE,R,E,2,Same,46
1077,3055,1978,0.600804448,0.614618194,556,571,56,1,'01_07_03.c3d',26,EE,R,E,3,Same,15
908,1011,103,0.991732725,0.762327068,498,423,267,47,'01_07_04.c3d',26,EE,R,E,4,Same,75
1129,1169,40,1.112930457,1.017661803,475,407,267,1,'01_07_05.c3d',26,EE,R,E,5,Same,68
1064,1502,438,1.08929451,0.869399834,850,909,39,545,'01_07_01.c3d',27,EE,R,E,1,Same,59
719,1368,649,1.620089342,1.176568892,605,585,381,361,'01_07_02.c3d',27,EE,R,E,2,Same,20
1373,1698,325,0.682249244,0.563770713,784,736,1,1,'01_07_03.c3d',27,EE,R,E,3,Same,48
1007,1334,327,1.08452845,0.646872704,705,673,430,1,'01_07_04.c3d',27,EE,R,E,4,Same,32
1117,1672,555,0.861827816,0.97319019,659,665,1,392,'01_07_05.c3d',27,EE,R,E,5,Same,6
755,1923,1168,0.859961134,0.848566502,1049,608,1,348,'01_07_01.c3d',28,EE,R,E,1,Same,441
910,1343,433,1.131892365,0.973208261,900,500,278,1,'01_07_02.c3d',28,EE,R,E,2,Same,400
1065,1105,40,1.267107707,0.823053377,639,561,1,1,'01_07_03.c3d',28,EE,R,E,3,Same,78
710,1387,677,0.857768282,0.681222299,587,542,248,248,'01_07_04.c3d',28,EE,R,E,4,Same,45
1071,1436,365,0.812287194,0.555041783,890,494,2,28,'01_07_05.c3d',28,EE,R,E,5,Same,396
583,795,212,2.231259796,1.494402392,580,516,353,1,'01_07_01.c3d',29,EE,R,E,1,Same,64
519,1354,835,2.247988607,1.531114287,510,464,275,1,'01_07_02.c3d',29,EE,R,E,2,Same,46
681,1102,421,1.453533702,1.088056608,567,528,1,357,'01_07_03.c3d',29,EE,R,E,3,Same,39
650,1211,561,1.307527617,1.00339215,537,499,324,1,'01_07_04.c3d',29,EE,R,E,4,Same,38
586,1088,502,1.010545402,0.91453485,494,436,16,1,'01_07_05.c3d',29,EE,R,E,5,Same,58
743,940,197,0.912979709,0.966206388,468,383,28,138,'01_07_01.c3d',30,EE,R,E,1,Same,85
824,950,126,1.076075771,0.83533357,425,369,105,1,'01_07_02.c3d',30,EE,R,E,2,Same,56
1049,1082,33,0.753438332,0.580656073,578,460,1,1,'01_07_03.c3d',30,EE,R,E,3,Same,118
650,890,240,1.012658331,0.915875767,680,472,1,1,'01_07_04.c3d',30,EE,R,E,4,Same,208
1006,1583,577,0.842513321,0.712821728,483,397,149,1,'01_07_05.c3d',30,EE,R,E,5,Same,86
734,1526,792,1.469383353,1.553246966,607,546,374,362,'01_07_01.c3d',31,EE,R,E,1,Same,61
1000,1610,610,1.722874723,1.357352238,539,479,303,293,'01_07_02.c3d',31,EE,R,E,2,Same,60
806,981,175,1.626839521,1.288548611,498,478,296,288,'01_07_03.c3d',31,EE,R,E,3,Same,20
608,922,314,2.663562202,1.621343666,518,490,1,298,'01_07_04.c3d',31,EE,R,E,4,Same,28
933,1244,311,1.538544888,1.306649926,573,499,333,33,'01_07_05.c3d',31,EE,R,E,5,Same,74
733,1171,438,1.394249088,0.912172888,549,545,1,70,'01_07_01.c3d',32,EE,R,E,1,Same,4
688,1245,557,1.580961462,1.026257042,557,517,1,299,'01_07_02.c3d',32,EE,R,E,2,Same,40
1144,1209,65,1.157504248,0.72062177,731,690,1,86,'01_07_03.c3d',32,EE,R,E,3,Same,41
960,1534,574,1.008620665,0.759721421,595,466,283,240,'01_07_04.c3d',32,EE,R,E,4,Same,129
1235,1608,373,0.900523037,0.572176216,662,723,323,1,'01_07_05.c3d',32,EE,R,E,5,Same,61
1031,1312,281,1.043091492,0.897629435,650,570,56,321,'01_07_01.c3d',33,EE,R,E,1,Same,80
803,1404,601,1.006630321,1.083455452,954,652,1,387,'01_07_02.c3d',33,EE,R,E,2,Same,302
815,1315,500,1.250061988,0.969893609,700,663,393,402,'01_07_03.c3d',33,EE,R,E,3,Same,37
884,1253,369,1.103172651,0.843255614,794,742,337,1,'01_07_04.c3d',33,EE,R,E,4,Same,52
764,1261,497,1.264992192,0.920824097,670,660,376,354,'01_07_05.c3d',33,EE,R,E,5,Same,10
588,1036,448,2.158992742,1.360890503,519,498,352,1,'01_07_01.c3d',34,EE,R,E,1,Same,21
426,914,488,1.792817933,1.456901775,390,354,217,75,'01_07_02.c3d',34,EE,R,E,2,Same,36
734,1197,463,1.023622331,0.846754019,568,432,282,1,'01_07_03.c3d',34,EE,R,E,3,Same,136
690,1304,614,1.131117945,0.857900643,543,466,310,64,'01_07_04.c3d',34,EE,R,E,4,Same,77
703,1266,563,1.200587028,0.91212253,461,376,246,236,'01_07_05.c3d',34,EE,R,E,5,Same,85
615,1048,433,2.002116935,1.153684332,504,448,309,1,'01_07_01.c3d',35,EE,R,E,1,Same,56
608,868,260,1.854473476,1.659211821,454,410,241,233,'01_07_02.c3d',35,EE,R,E,2,Same,44
772,989,217,1.098003471,0.947457112,484,797,1,1,'01_07_03.c3d',35,EE,R,E,3,Same,313
634,999,365,1.588711361,1.123830285,556,500,15,287,'01_07_04.c3d',35,EE,R,E,4,Same,56
799,811,12,1.266775733,0.785815526,720,404,218,223,'01_07_05.c3d',35,EE,R,E,5,Same,316
1025,1819,794,0.775675271,0.605638054,723,688,482,1,'01_08_01.c3d',1,EE,R,M,1,Same,35
526,1261,735,1.145271087,1.101987264,489,459,127,151,'01_08_02.c3d',1,EE,R,M,2,Same,30
1093,1253,160,0.990020142,0.724673929,709,557,38,1,'01_08_03.c3d',1,EE,R,M,3,Same,152
613,1087,474,1.055161671,0.582981902,616,423,42,1,'01_08_04.c3d',1,EE,R,M,4,Same,193
795,1430,635,0.968631396,0.825798192,548,556,208,1,'01_08_05.c3d',1,EE,R,M,5,Same,8
1078,1930,852,0.600088983,0.87844533,902,616,38,1,'01_08_01.c3d',2,EE,R,M,1,Same,286
768,1411,643,1.028395971,0.813952289,524,561,1,240,'01_08_02.c3d',2,EE,R,M,2,Same,37
1310,1672,362,0.650818129,0.609095393,492,441,1,1,'01_08_03.c3d',2,EE,R,M,3,Same,51
988,1285,297,0.706907616,0.681388897,581,488,54,252,'01_08_04.c3d',2,EE,R,M,4,Same,93
1146,1288,142,0.975815371,0.910169913,672,412,39,211,'01_08_05.c3d',2,EE,R,M,5,Same,260
726,981,255,1.795454106,0.812424258,607,430,103,1,'01_08_01.c3d',3,EE,R,M,1,Same,177
481,934,453,2.21745404,1.957317098,452,456,283,1,'01_08_02.c3d',3,EE,R,M,2,Same,4
512,800,288,1.466875549,1.791130307,509,448,313,1,'01_08_03.c3d',3,EE,R,M,3,Same,61
481,1144,663,1.05254861,1.349483069,455,408,240,1,'01_08_04.c3d',3,EE,R,M,4,Same,47
821,834,13,1.497310699,0.631361569,504,470,114,21,'01_08_05.c3d',3,EE,R,M,5,Same,34
740,1288,548,1.211215008,1.019149221,640,659,408,124,'01_08_01.c3d',4,EE,R,M,1,Same,19
815,927,112,2.034561065,1.459744283,641,590,411,1,'01_08_02.c3d',4,EE,R,M,2,Same,51
765,4614,3849,2.13808926,1.534151652,3776,3758,1,141,'01_08_03.c3d',4,EE,R,M,3,Same,18
643,1099,456,1.35588729,0.933315476,513,475,254,273,'01_08_04.c3d',4,EE,R,M,4,Same,38
674,1158,484,1.019435033,0.761273445,539,531,305,24,'01_08_05.c3d',4,EE,R,M,5,Same,8
734,806,72,1.974273768,1.177407187,444,422,264,248,'01_08_01.c3d',5,EE,R,M,1,Same,22
482,911,429,2.892861932,1.734984016,432,438,289,277,'01_08_02.c3d',5,EE,R,M,2,Same,6
399,1111,712,2.115863635,1.461930803,386,317,156,1,'01_08_03.c3d',5,EE,R,M,3,Same,69
394,890,496,2.855759059,1.630705285,388,381,220,78,'01_08_04.c3d',5,EE,R,M,4,Same,7
582,648,66,2.373159693,1.745475234,471,449,295,292,'01_08_05.c3d',5,EE,R,M,5,Same,22
618,1586,968,1.438268808,1.10128188,1177,448,297,1,'01_08_01.c3d',6,EE,R,M,1,Same,729
1153,1795,642,0.875010797,1.120771108,868,595,297,61,'01_08_02.c3d',6,EE,R,M,2,Same,273
665,1369,704,1.391163088,1.161423278,908,558,1,1,'01_08_03.c3d',6,EE,R,M,3,Same,350
636,1169,533,1.305410941,0.959280878,945,480,1,1,'01_08_04.c3d',6,EE,R,M,4,Same,465
672,1735,1063,0.916548412,1.066389951,945,510,1,1,'01_08_05.c3d',6,EE,R,M,5,Same,435
939,1037,98,1.050582722,0.554314664,534,506,323,6,'01_08_01.c3d',7,EE,R,M,1,Same,28
911,977,66,1.191296613,0.832616602,436,406,229,1,'01_08_02.c3d',7,EE,R,M,2,Same,30
774,938,164,1.289662669,0.787362889,548,474,19,1,'01_08_03.c3d',7,EE,R,M,3,Same,74
551,974,423,1.223345891,0.861701538,470,112,1,1,'01_08_04.c3d',7,EE,R,M,4,Same,358
1011,1563,552,1.181262361,0.594871674,483,446,247,252,'01_08_05.c3d',7,EE,R,M,5,Same,37
696,1875,1179,1.326440483,0.999272643,591,648,51,1,'01_08_01.c3d',8,EE,R,M,1,Same,57
970,1190,220,1.35457585,0.915285896,552,504,1,1,'01_08_02.c3d',8,EE,R,M,2,Same,48
1100,1167,67,1.597502998,0.932158804,587,557,358,337,'01_08_03.c3d',8,EE,R,M,3,Same,30
916,1702,786,0.77423703,0.42353449,537,355,1,1,'01_08_04.c3d',8,EE,R,M,4,Same,182
825,1050,225,1.067401176,0.689934181,468,495,1,131,'01_08_05.c3d',8,EE,R,M,5,Same,27
642,1467,825,1.224128634,1.040010528,502,459,297,292,'01_08_01.c3d',9,EE,R,M,1,Same,43
869,1725,856,1.33763121,1.179473979,424,390,249,247,'01_08_02.c3d',9,EE,R,M,2,Same,34
1333,2330,997,1.411976465,1.195923386,1276,1197,1050,1,'01_08_03.c3d',9,EE,R,M,3,Same,79
610,1659,1049,1.256278633,1.157852426,446,462,260,268,'01_08_04.c3d',9,EE,R,M,4,Same,16
917,1978,1061,0.84511408,0.891618982,1461,473,64,90,'01_08_05.c3d',9,EE,R,M,5,Same,988
1331,1341,10,3.049742929,1.370197198,533,508,370,1,'01_08_01.c3d',10,EE,R,M,1,Same,25
865,1115,250,1.995016774,0.814946512,467,555,288,1,'01_08_02.c3d',10,EE,R,M,2,Same,88
842,982,140,1.426791979,1.012733651,460,467,265,267,'01_08_03.c3d',10,EE,R,M,3,Same,7
934,976,42,1.409917047,1.000547337,418,441,74,159,'01_08_04.c3d',10,EE,R,M,4,Same,23
500,1059,559,1.604167679,1.372564159,459,417,250,140,'01_08_05.c3d',10,EE,R,M,5,Same,42
1417,1892,475,0.77875604,0.739881241,1072,671,1,1,'01_08_01.c3d',11,EE,R,M,1,Same,401
1175,2045,870,0.49636832,0.471429721,1555,1120,1,1,'01_08_02.c3d',11,EE,R,M,2,Same,435
889,1781,892,0.70285174,0.703340532,548,522,300,85,'01_08_03.c3d',11,EE,R,M,3,Same,26
1134,1905,771,0.678143024,0.592927992,680,703,1,370,'01_08_04.c3d',11,EE,R,M,4,Same,23
1249,1697,448,0.712718046,0.570975946,1101,606,351,1,'01_08_05.c3d',11,EE,R,M,5,Same,495
744,759,15,1.741733584,0.931441919,460,428,285,237,'01_08_01.c3d',12,EE,R,M,1,Same,32
659,802,143,1.738121022,1.206215098,434,398,254,2,'01_08_02.c3d',12,EE,R,M,2,Same,36
509,624,115,1.959883357,1.190484443,444,422,256,227,'01_08_03.c3d',12,EE,R,M,3,Same,22
542,1520,978,1.450933906,1.188210453,458,465,279,266,'01_08_04.c3d',12,EE,R,M,4,Same,7
267,956,689,1.1708321,1.041278488,519,195,1,1,'01_08_05.c3d',12,EE,R,M,5,Same,324
1102,1110,8,1.056350105,0.979171819,568,577,1,1,'01_08_01.c3d',13,EE,R,M,1,Same,9
1040,1062,22,1.270475418,1.119770191,544,546,336,1,'01_08_02.c3d',13,EE,R,M,2,Same,2
665,1634,969,1.510321214,1.081797945,575,517,308,1,'01_08_03.c3d',13,EE,R,M,3,Same,58
587,1131,544,1.379153069,1.341658824,525,491,136,273,'01_08_04.c3d',13,EE,R,M,4,Same,34
479,719,240,1.520715807,0.888903867,393,356,1,1,'01_08_05.c3d',13,EE,R,M,5,Same,37
1053,1133,80,1.544375528,0.907466124,561,543,14,1,'01_08_01.c3d',14,EE,R,M,1,Same,18
467,926,459,2.774624173,1.676144112,430,433,264,1,'01_08_02.c3d',14,EE,R,M,2,Same,3
592,862,270,2.116435254,1.377925185,465,451,292,1,'01_08_03.c3d',14,EE,R,M,3,Same,14
528,855,327,2.134545464,1.700102739,456,459,1,307,'01_08_04.c3d',14,EE,R,M,4,Same,3
439,1186,747,1.735523163,1.778625589,388,392,48,38,'01_08_05.c3d',14,EE,R,M,5,Same,4
910,1146,236,1.420680987,1.117196019,546,500,1,1,'01_08_01.c3d',15,EE,R,M,1,Same,46
906,1205,299,1.337777257,0.940148466,516,471,1,111,'01_08_02.c3d',15,EE,R,M,2,Same,45
883,1252,369,1.314389477,1.03575698,513,472,42,281,'01_08_03.c3d',15,EE,R,M,3,Same,41
387,870,483,1.411991107,0.96194533,426,271,68,1,'01_08_04.c3d',15,EE,R,M,4,Same,155
715,1274,559,1.05746771,0.719313471,430,390,67,1,'01_08_05.c3d',15,EE,R,M,5,Same,40
874,1063,189,1.628079417,1.174192987,472,425,295,249,'01_08_01.c3d',16,EE,R,M,1,Same,47
526,1525,999,1.410691176,1.176268586,457,418,240,1,'01_08_02.c3d',16,EE,R,M,2,Same,39
825,920,95,1.334659429,0.913464819,528,483,290,1,'01_08_03.c3d',16,EE,R,M,3,Same,45
795,952,157,1.176601319,0.886463585,486,446,271,39,'01_08_04.c3d',16,EE,R,M,4,Same,40
498,1007,509,1.730408298,1.394028107,561,417,1,238,'01_08_05.c3d',16,EE,R,M,5,Same,144
882,1294,412,1.682452012,1.011451117,493,445,317,296,'01_08_01.c3d',17,EE,R,M,1,Same,48
657,875,218,2.189951921,1.570764466,453,441,298,306,'01_08_02.c3d',17,EE,R,M,2,Same,12
530,693,163,2.982634589,3.023176996,381,371,259,260,'01_08_03.c3d',17,EE,R,M,3,Same,10
481,884,403,2.362432292,1.435593661,423,398,258,241,'01_08_04.c3d',17,EE,R,M,4,Same,25
405,589,184,2.820656426,2.159484313,401,374,254,1,'01_08_05.c3d',17,EE,R,M,5,Same,27
709,1048,339,1.780258521,1.009864284,534,530,333,341,'01_08_01.c3d',18,EE,R,M,1,Same,4
596,1527,931,1.925571243,1.404770013,540,504,46,291,'01_08_02.c3d',18,EE,R,M,2,Same,36
917,1009,92,1.750982756,1.828046843,516,470,1,1,'01_08_03.c3d',18,EE,R,M,3,Same,46
556,921,365,1.432599007,1.267844726,515,479,1,1,'01_08_04.c3d',18,EE,R,M,4,Same,36
538,1031,493,1.393557315,1.242685915,516,512,13,1,'01_08_05.c3d',18,EE,R,M,5,Same,4
742,1225,483,0.943572492,0.681661247,533,493,291,252,'01_08_01.c3d',19,EE,R,M,1,Same,40
831,1407,576,0.902313147,0.989768627,469,419,248,248,'01_08_02.c3d',19,EE,R,M,2,Same,50
560,1248,688,0.932551832,1.222775063,458,421,252,76,'01_08_03.c3d',19,EE,R,M,3,Same,37
657,974,317,1.070951016,1.125246194,454,391,72,182,'01_08_04.c3d',19,EE,R,M,4,Same,63
617,1199,582,1.542518678,0.946782412,520,488,232,1,'01_08_05.c3d',19,EE,R,M,5,Same,32
1953,2094,141,0.647628677,0.557396537,1314,1338,1,663,'01_08_01.c3d',20,EE,R,M,1,Same,24
756,1535,779,1.127465106,0.945766385,515,496,207,41,'01_08_02.c3d',20,EE,R,M,2,Same,19
844,1240,396,1.355898587,1.2065756,550,522,384,371,'01_08_03.c3d',20,EE,R,M,3,Same,28
466,1018,552,1.442285672,1.180926759,440,414,157,53,'01_08_04.c3d',20,EE,R,M,4,Same,26
643,1404,761,1.554651823,1.109898374,453,440,281,250,'01_08_05.c3d',20,EE,R,M,5,Same,13
873,1374,501,0.904609502,0.63618947,584,530,1,130,'01_08_01.c3d',21,EE,R,M,1,Same,54
726,939,213,1.737341479,0.849652626,588,560,350,189,'01_08_02.c3d',21,EE,R,M,2,Same,28
976,1537,561,0.734647723,0.678316412,1081,678,1,469,'01_08_03.c3d',21,EE,R,M,3,Same,403
1044,1383,339,1.542591807,1.100889358,553,558,97,86,'01_08_04.c3d',21,EE,R,M,4,Same,5
822,1290,468,0.827361145,0.697313495,378,379,173,1,'01_08_05.c3d',21,EE,R,M,5,Same,1
634,1559,925,0.926365989,1.627840735,594,550,319,346,'01_08_01.c3d',22,EE,R,M,1,Same,44
1207,1620,413,1.010680171,0.770665746,864,805,408,70,'01_08_02.c3d',22,EE,R,M,2,Same,59
1264,1911,647,0.600955977,1.288381564,719,743,425,500,'01_08_03.c3d',22,EE,R,M,3,Same,24
1147,1620,473,0.699093471,0.97558478,595,589,97,60,'01_08_04.c3d',22,EE,R,M,4,Same,6
790,1208,418,0.956018251,1.120515316,545,506,306,1,'01_08_05.c3d',22,EE,R,M,5,Same,39
1451,5998,4547,0.858409326,0.39195426,1750,998,408,128,'01_08_01.c3d',23,EE,R,M,1,Same,752
1002,2590,1588,0.630250799,0.73664706,496,667,1,43,'01_08_02.c3d',23,EE,R,M,2,Same,171
1824,2669,845,0.499701437,0.392096745,2080,1459,74,6,'01_08_03.c3d',23,EE,R,M,3,Same,621
2113,3449,1336,0.463933425,0.432837116,1227,1357,1,73,'01_08_04.c3d',23,EE,R,M,4,Same,130
1612,2321,709,0.530035496,0.360236873,901,1415,20,256,'01_08_05.c3d',23,EE,R,M,5,Same,514
640,1095,455,1.544834395,1.374195827,490,488,287,307,'01_08_01.c3d',24,EE,R,M,1,Same,2
743,932,189,1.568838992,1.292511061,578,489,85,301,'01_08_02.c3d',24,EE,R,M,2,Same,89
909,966,57,1.34546733,1.118234062,452,403,232,1,'01_08_03.c3d',24,EE,R,M,3,Same,49
643,947,304,1.352261009,0.666752089,473,466,209,1,'01_08_04.c3d',24,EE,R,M,4,Same,7
536,1113,577,1.511874318,0.920145493,450,368,188,14,'01_08_05.c3d',24,EE,R,M,5,Same,82
855,949,94,1.926162462,1.293042326,470,422,310,285,'01_08_01.c3d',25,EE,R,M,1,Same,48
674,1107,433,1.329005289,0.839974633,563,482,301,275,'01_08_02.c3d',25,EE,R,M,2,Same,81
827,1203,376,1.233962726,0.740296227,552,500,268,253,'01_08_03.c3d',25,EE,R,M,3,Same,52
642,1312,670,1.254177409,0.78302343,534,540,291,290,'01_08_04.c3d',25,EE,R,M,4,Same,6
578,1693,1115,1.30377911,1.000195764,569,500,293,284,'01_08_05.c3d',25,EE,R,M,5,Same,69
1026,1320,294,0.830792428,0.681961011,479,422,30,23,'01_08_01.c3d',26,EE,R,M,1,Same,57
1003,2692,1689,1.188232844,0.588003641,630,1006,381,28,'01_08_02.c3d',26,EE,R,M,2,Same,376
1103,1824,721,0.910036493,0.70076861,967,477,303,257,'01_08_03.c3d',26,EE,R,M,3,Same,490
1185,1270,85,0.779565538,0.595120126,514,472,291,39,'01_08_04.c3d',26,EE,R,M,4,Same,42
871,1416,545,0.70154096,0.651057197,470,417,12,47,'01_08_05.c3d',26,EE,R,M,5,Same,53
976,1561,585,0.656664288,0.551876643,988,535,309,276,'01_08_01.c3d',27,EE,R,M,1,Same,453
998,1473,475,0.966625165,0.54186553,636,529,347,1,'01_08_02.c3d',27,EE,R,M,2,Same,107
1149,1455,306,0.961049961,0.844860781,682,663,11,86,'01_08_03.c3d',27,EE,R,M,3,Same,19
904,1713,809,0.752539836,0.613516902,677,648,76,42,'01_08_04.c3d',27,EE,R,M,4,Same,29
1105,1540,435,1.16412467,0.615077836,636,615,417,87,'01_08_05.c3d',27,EE,R,M,5,Same,21
1167,2243,1076,0.755148895,0.52632531,1077,653,13,32,'01_08_01.c3d',28,EE,R,M,1,Same,424
1008,1390,382,1.125029612,0.640342437,503,869,1,296,'01_08_02.c3d',28,EE,R,M,2,Same,366
2067,2632,565,0.965523611,0.690903004,1613,1350,1137,1,'01_08_03.c3d',28,EE,R,M,3,Same,263
898,1088,190,1.048127157,0.67217921,627,547,294,244,'01_08_04.c3d',28,EE,R,M,4,Same,80
1144,1363,219,0.898781909,0.646873884,702,700,1,1,'01_08_05.c3d',28,EE,R,M,5,Same,2
532,1231,699,1.935246181,1.545215339,559,450,289,291,'01_08_01.c3d',29,EE,R,M,1,Same,109
549,1419,870,1.824227497,1.458964498,533,456,1,1,'01_08_02.c3d',29,EE,R,M,2,Same,77
502,1416,914,1.589300715,1.384568939,503,431,257,250,'01_08_03.c3d',29,EE,R,M,3,Same,72
577,921,344,1.719571626,1.077310463,504,435,21,119,'01_08_04.c3d',29,EE,R,M,4,Same,69
1113,1971,858,0.544465597,0.598993524,1035,491,1,8,'01_08_05.c3d',29,EE,R,M,5,Same,544
579,827,248,1.514095888,1.169458427,572,498,288,294,'01_08_01.c3d',30,EE,R,M,1,Same,74
568,975,407,1.39782886,0.995339323,523,437,276,1,'01_08_02.c3d',30,EE,R,M,2,Same,86
823,1092,269,0.823871454,0.719895385,479,463,1,259,'01_08_03.c3d',30,EE,R,M,3,Same,16
882,1323,441,0.641968129,0.645336212,852,397,1,161,'01_08_04.c3d',30,EE,R,M,4,Same,455
848,1275,427,0.841925217,0.820198083,474,428,163,213,'01_08_05.c3d',30,EE,R,M,5,Same,46
770,1084,314,3.115148033,1.914681448,628,583,429,413,'01_08_01.c3d',31,EE,R,M,1,Same,45
577,987,410,1.793993441,1.576671319,485,450,305,300,'01_08_02.c3d',31,EE,R,M,2,Same,35
1005,1039,34,1.691038675,1.152712938,530,463,80,273,'01_08_03.c3d',31,EE,R,M,3,Same,67
656,1102,446,2.15331775,1.233335574,517,533,315,312,'01_08_04.c3d',31,EE,R,M,4,Same,16
958,1020,62,1.493903593,1.123036882,473,429,296,269,'01_08_05.c3d',31,EE,R,M,5,Same,44
775,1188,413,1.770392041,0.693150776,543,498,78,44,'01_08_01.c3d',32,EE,R,M,1,Same,45
647,1169,522,1.569182328,0.876416588,507,475,282,257,'01_08_02.c3d',32,EE,R,M,2,Same,32
656,1165,509,1.244439553,0.882324933,512,545,274,279,'01_08_03.c3d',32,EE,R,M,3,Same,33
687,1284,597,1.444939182,0.83857066,499,499,273,16,'01_08_04.c3d',32,EE,R,M,4,Same,0
696,1198,502,1.081335317,0.775626573,544,581,1,59,'01_08_05.c3d',32,EE,R,M,5,Same,37
1117,1403,286,0.794228373,0.877674319,963,545,16,293,'01_08_01.c3d',33,EE,R,M,1,Same,418
687,1182,495,1.374957371,1.056741974,653,536,364,294,'01_08_02.c3d',33,EE,R,M,2,Same,117
914,1468,554,0.998431929,0.658455463,640,759,1,1,'01_08_03.c3d',33,EE,R,M,3,Same,119
705,1051,346,1.313276331,1.218026483,675,588,382,341,'01_08_04.c3d',33,EE,R,M,4,Same,87
1129,1463,334,1.023282668,0.576749203,1046,622,408,384,'01_08_05.c3d',33,EE,R,M,5,Same,424
2900,3148,248,0.725444469,0.482775775,2135,2416,41,1,'01_08_01.c3d',34,EE,R,M,1,Same,281
872,1073,201,1.338136484,1.008582656,630,484,346,331,'01_08_02.c3d',34,EE,R,M,2,Same,146
581,974,393,1.512253128,1.484232762,426,428,276,1,'01_08_03.c3d',34,EE,R,M,3,Same,2
594,1061,467,1.225599151,0.855552357,538,413,270,1,'01_08_04.c3d',34,EE,R,M,4,Same,125
727,1633,906,0.880815205,1.01487061,951,582,77,298,'01_08_05.c3d',34,EE,R,M,5,Same,369
563,1128,565,1.464985114,1.102192584,471,431,249,1,'01_08_01.c3d',35,EE,R,M,1,Same,40
579,958,379,1.955981146,1.247004672,496,464,281,83,'01_08_02.c3d',35,EE,R,M,2,Same,32
821,1132,311,1.835285922,0.958045863,624,694,54,1,'01_08_03.c3d',35,EE,R,M,3,Same,70
628,1535,907,1.711942365,1.152435477,498,460,282,72,'01_08_04.c3d',35,EE,R,M,4,Same,38
792,1421,629,1.452219057,0.891330889,489,397,231,1,'01_08_05.c3d',35,EE,R,M,5,Same,92
766,1070,304,1.404445704,0.736830607,654,492,290,37,'01_09_01.c3d',1,EE,R,H,1,Same,162
995,2302,1307,1.115652329,0.871427086,813,773,265,1,'01_09_02.c3d',1,EE,R,H,2,Same,40
494,1021,527,1.178693495,1.158761514,422,385,158,8,'01_09_03.c3d',1,EE,R,H,3,Same,37
824,1424,600,1.286138182,0.719709716,533,686,1,3,'01_09_04.c3d',1,EE,R,H,4,Same,153
1247,2200,953,1.097118223,0.615040482,827,525,71,326,'01_09_05.c3d',1,EE,R,H,5,Same,302
860,1331,471,0.675905005,0.729472051,549,501,55,19,'01_09_01.c3d',2,EE,R,H,1,Same,48
707,1179,472,0.900535317,0.823378397,528,532,23,52,'01_09_02.c3d',2,EE,R,H,2,Same,4
1226,1547,321,0.773295424,0.63367927,561,795,316,1,'01_09_03.c3d',2,EE,R,H,3,Same,234
838,1138,300,1.128583839,1.042891996,607,506,28,317,'01_09_04.c3d',2,EE,R,H,4,Same,101
948,1389,441,0.780972408,0.698806438,463,435,221,11,'01_09_05.c3d',2,EE,R,H,5,Same,28
451,921,470,1.898392495,1.637976493,404,384,162,1,'01_09_01.c3d',3,EE,R,H,1,Same,20
473,935,462,2.009040478,1.765290771,492,436,71,1,'01_09_02.c3d',3,EE,R,H,2,Same,56
771,1013,242,1.153856564,0.969640002,383,393,159,148,'01_09_03.c3d',3,EE,R,H,3,Same,10
593,952,359,1.564688817,1.635379667,531,501,1,1,'01_09_04.c3d',3,EE,R,H,4,Same,30
721,788,67,1.240911895,0.966046407,318,344,1,166,'01_09_05.c3d',3,EE,R,H,5,Same,26
937,1222,285,2.009599475,0.94980638,518,498,330,36,'01_09_01.c3d',4,EE,R,H,1,Same,20
593,1739,1146,1.580403298,0.988774213,622,495,301,35,'01_09_02.c3d',4,EE,R,H,2,Same,127
794,1204,410,1.173787567,0.700022305,543,515,303,118,'01_09_03.c3d',4,EE,R,H,3,Same,28
807,824,17,1.196449893,0.635227606,475,453,1,1,'01_09_04.c3d',4,EE,R,H,4,Same,22
872,1154,282,0.938897905,0.691047531,525,418,232,1,'01_09_05.c3d',4,EE,R,H,5,Same,107
763,1004,241,2.596769904,1.553896224,426,411,286,279,'01_09_01.c3d',5,EE,R,H,1,Same,15
406,889,483,3.613797022,2.511261815,392,383,255,257,'01_09_02.c3d',5,EE,R,H,2,Same,9
390,1057,667,3.205863683,2.06436615,382,365,64,1,'01_09_03.c3d',5,EE,R,H,3,Same,17
247,792,545,2.644876078,1.81235803,201,231,15,1,'01_09_04.c3d',5,EE,R,H,4,Same,30
434,683,249,2.56231373,1.591003199,372,351,130,213,'01_09_05.c3d',5,EE,R,H,5,Same,21
719,1537,818,1.381036752,0.926484426,1102,465,310,1,'01_09_01.c3d',6,EE,R,H,1,Same,637
870,1622,752,1.620337963,1.089999207,1124,511,32,276,'01_09_02.c3d',6,EE,R,H,2,Same,613
839,1473,634,0.872523525,0.693665794,1071,477,463,1,'01_09_03.c3d',6,EE,R,H,3,Same,594
694,1426,732,1.030439976,1.227818854,1289,542,1,377,'01_09_04.c3d',6,EE,R,H,4,Same,747
839,1643,804,0.737009034,1.235284043,1166,503,21,1,'01_09_05.c3d',6,EE,R,H,5,Same,663
1211,1379,168,1.060440613,0.698959957,608,565,1,1,'01_09_01.c3d',7,EE,R,H,1,Same,43
672,1085,413,1.27018444,0.812182165,533,480,4,1,'01_09_02.c3d',7,EE,R,H,2,Same,53
533,894,361,1.457982026,0.900862028,434,400,231,50,'01_09_03.c3d',7,EE,R,H,3,Same,34
898,1773,875,1.197848691,0.768867089,473,429,245,40,'01_09_04.c3d',7,EE,R,H,4,Same,44
578,961,383,1.506063889,1.052058435,448,386,197,1,'01_09_05.c3d',7,EE,R,H,5,Same,62
2097,2313,216,0.655484216,0.581336303,985,974,1,1,'01_09_01.c3d',8,EE,R,H,1,Same,11
756,1632,876,1.103960665,0.851638286,612,641,1,11,'01_09_02.c3d',8,EE,R,H,2,Same,29
615,1226,611,1.226313347,0.969950346,484,456,253,49,'01_09_03.c3d',8,EE,R,H,3,Same,28
1227,1739,512,0.875767623,0.650499877,434,421,221,107,'01_09_04.c3d',8,EE,R,H,4,Same,13
792,1495,703,1.126728423,0.762272594,534,508,1,1,'01_09_05.c3d',8,EE,R,H,5,Same,26
1137,2348,1211,0.768432248,0.988525363,707,659,503,505,'01_09_01.c3d',9,EE,R,H,1,Same,48
708,2006,1298,0.882087761,1.21804592,426,392,241,1,'01_09_02.c3d',9,EE,R,H,2,Same,34
564,1794,1230,1.40385077,1.419008159,427,387,1,242,'01_09_03.c3d',9,EE,R,H,3,Same,40
1026,1612,586,0.807039681,0.711495467,477,549,270,1,'01_09_04.c3d',9,EE,R,H,4,Same,72
920,2283,1363,0.962483686,0.848724964,507,471,1,37,'01_09_05.c3d',9,EE,R,H,5,Same,36
701,1162,461,2.224190068,0.903421347,503,414,277,241,'01_09_01.c3d',10,EE,R,H,1,Same,89
688,1131,443,2.368808824,1.091553623,440,390,246,251,'01_09_02.c3d',10,EE,R,H,2,Same,50
627,1124,497,2.531069177,1.160260866,420,420,243,237,'01_09_03.c3d',10,EE,R,H,3,Same,0
611,1407,796,1.275017436,1.264240107,446,454,253,251,'01_09_04.c3d',10,EE,R,H,4,Same,8
982,1108,126,1.613572465,1.464959218,470,470,224,289,'01_09_05.c3d',10,EE,R,H,5,Same,0
1026,1942,916,0.57856732,0.460409683,551,893,295,10,'01_09_01.c3d',11,EE,R,H,1,Same,342
1320,2174,854,0.542112395,0.416073471,1280,839,311,1,'01_09_02.c3d',11,EE,R,H,2,Same,441
1699,2497,798,0.479625338,0.255562474,1618,636,79,134,'01_09_03.c3d',11,EE,R,H,3,Same,982
1166,2086,920,0.544937197,0.563371834,768,709,55,1,'01_09_04.c3d',11,EE,R,H,4,Same,59
1644,2795,1151,0.402683019,0.436169894,1339,622,311,1,'01_09_05.c3d',11,EE,R,H,5,Same,717
1100,1674,574,1.0106232,0.842186903,604,596,407,398,'01_09_01.c3d',12,EE,R,H,1,Same,8
956,1325,369,1.251953489,0.884866061,473,471,270,37,'01_09_02.c3d',12,EE,R,H,2,Same,2
630,783,153,1.463852135,0.941539713,485,447,290,276,'01_09_03.c3d',12,EE,R,H,3,Same,38
584,704,120,1.591424217,1.037426872,456,422,272,151,'01_09_04.c3d',12,EE,R,H,4,Same,34
815,1611,796,0.706520463,0.849631503,391,360,82,1,'01_09_05.c3d',12,EE,R,H,5,Same,31
1716,2634,918,0.831328971,0.370198753,1182,1182,1,1,'01_09_01.c3d',13,EE,R,H,1,Same,0
921,1558,637,1.451428371,0.827420658,460,449,30,1,'01_09_02.c3d',13,EE,R,H,2,Same,11
848,923,75,1.74710652,1.167225582,420,372,27,15,'01_09_03.c3d',13,EE,R,H,3,Same,48
555,1427,872,1.412635613,1.176654921,486,438,199,1,'01_09_04.c3d',13,EE,R,H,4,Same,48
584,1184,600,1.607665217,1.342460354,508,502,304,1,'01_09_05.c3d',13,EE,R,H,5,Same,6
684,1610,926,1.688803472,1.162795127,606,609,1,1,'01_09_01.c3d',14,EE,R,H,1,Same,3
500,989,489,2.135210268,1.842488306,448,446,1,106,'01_09_02.c3d',14,EE,R,H,2,Same,2
332,650,318,1.697788821,1.727237995,318,315,1,1,'01_09_03.c3d',14,EE,R,H,3,Same,3
639,1475,836,1.745571273,1.240344094,377,396,229,247,'01_09_04.c3d',14,EE,R,H,4,Same,19
546,1339,793,1.254746771,1.201677925,463,418,1,47,'01_09_05.c3d',14,EE,R,H,5,Same,45
1039,1078,39,1.448181733,0.920236252,720,588,10,14,'01_09_01.c3d',15,EE,R,H,1,Same,132
469,1013,544,1.706709119,1.693852357,480,452,293,48,'01_09_02.c3d',15,EE,R,H,2,Same,28
814,838,24,1.442161323,0.908245902,444,399,196,144,'01_09_03.c3d',15,EE,R,H,3,Same,45
768,938,170,1.081613399,0.687265685,456,188,1,1,'01_09_04.c3d',15,EE,R,H,4,Same,268
870,1361,491,1.106904165,0.82220568,488,408,33,1,'01_09_05.c3d',15,EE,R,H,5,Same,80
996,1053,57,1.318659427,0.941775457,550,552,1,1,'01_09_01.c3d',16,EE,R,H,1,Same,2
926,1514,588,2.380059325,0.949471491,620,509,44,268,'01_09_02.c3d',16,EE,R,H,2,Same,111
630,992,362,1.346830927,1.186543278,598,412,273,1,'01_09_03.c3d',16,EE,R,H,3,Same,186
722,1005,283,1.472255576,1.241613949,603,414,199,140,'01_09_04.c3d',16,EE,R,H,4,Same,189
846,2173,1327,1.28144852,0.943598851,490,462,278,253,'01_09_05.c3d',16,EE,R,H,5,Same,28
866,968,102,1.538103455,1.23619661,745,565,1,1,'01_09_01.c3d',17,EE,R,H,1,Same,180
503,775,272,3.290385848,2.537215674,383,378,264,260,'01_09_02.c3d',17,EE,R,H,2,Same,5
472,780,308,2.410484103,2.466666188,364,345,236,226,'01_09_03.c3d',17,EE,R,H,3,Same,19
545,559,14,2.489695217,1.944728741,364,355,213,35,'01_09_04.c3d',17,EE,R,H,4,Same,9
534,857,323,2.446987221,2.164934155,402,397,69,262,'01_09_05.c3d',17,EE,R,H,5,Same,5
775,1533,758,1.550988722,1.275970423,640,625,1,12,'01_09_01.c3d',18,EE,R,H,1,Same,15
800,1143,343,1.710700298,1.119131895,508,510,337,1,'01_09_02.c3d',18,EE,R,H,2,Same,2
872,1313,441,1.95279228,1.266111757,541,1111,85,1,'01_09_03.c3d',18,EE,R,H,3,Same,570
1,1052,1051,2.107351712,1.73171016,180,1,1,1,'01_09_04.c3d',18,EE,R,H,4,Same,179
540,689,149,1.570015244,0.818989875,480,135,1,1,'01_09_05.c3d',18,EE,R,H,5,Same,345
768,1443,675,0.730156601,0.706832248,418,432,1,258,'01_09_01.c3d',19,EE,R,H,1,Same,14
783,1388,605,0.996983355,0.974087405,476,444,1,1,'01_09_02.c3d',19,EE,R,H,2,Same,32
627,1008,381,1.266813434,0.873913799,455,450,18,269,'01_09_03.c3d',19,EE,R,H,3,Same,5
670,1360,690,0.931454076,0.936235115,501,475,208,1,'01_09_04.c3d',19,EE,R,H,4,Same,26
583,1081,498,0.892609006,0.982628362,510,455,1,267,'01_09_05.c3d',19,EE,R,H,5,Same,55
853,879,26,1.472232816,0.935906957,450,436,49,1,'01_09_01.c3d',20,EE,R,H,1,Same,14
608,1160,552,1.480889234,1.227488644,510,490,312,27,'01_09_02.c3d',20,EE,R,H,2,Same,20
963,1150,187,1.238096893,0.687998001,464,486,1,30,'01_09_03.c3d',20,EE,R,H,3,Same,22
833,1696,863,1.230619886,1.054283614,453,441,295,1,'01_09_04.c3d',20,EE,R,H,4,Same,12
658,1179,521,1.14500044,1.045119894,470,418,271,1,'01_09_05.c3d',20,EE,R,H,5,Same,52
874,1038,164,1.374491148,0.664586652,533,505,36,25,'01_09_01.c3d',21,EE,R,H,1,Same,28
980,1068,88,0.997838744,0.878517404,431,396,1,1,'01_09_02.c3d',21,EE,R,H,2,Same,35
830,1501,671,0.973271072,0.627757934,442,460,241,1,'01_09_03.c3d',21,EE,R,H,3,Same,18
831,1065,234,1.010160809,0.898576334,435,424,1,77,'01_09_04.c3d',21,EE,R,H,4,Same,11
1201,1841,640,0.880571023,0.617617298,474,773,1,36,'01_09_05.c3d',21,EE,R,H,5,Same,299
1128,2412,1284,0.606045648,0.872712168,704,742,432,1,'01_09_01.c3d',22,EE,R,H,1,Same,38
953,1586,633,0.837406647,1.394701647,530,516,317,1,'01_09_02.c3d',22,EE,R,H,2,Same,14
786,1731,945,0.727244851,1.03275201,543,618,1,57,'01_09_03.c3d',22,EE,R,H,3,Same,75
824,1369,545,1.032948729,1.030077742,563,588,339,1,'01_09_04.c3d',22,EE,R,H,4,Same,25
1042,2176,1134,0.733715222,1.164704312,1356,562,706,372,'01_09_05.c3d',22,EE,R,H,5,Same,794
1547,4591,3044,0.472068182,0.389451205,2047,1150,335,1,'01_09_01.c3d',23,EE,R,H,1,Same,897
2100,3837,1737,0.895903925,0.387453881,1605,579,1,1,'01_09_02.c3d',23,EE,R,H,2,Same,1026
1903,3603,1700,0.434873535,0.398846806,2386,691,1,45,'01_09_03.c3d',23,EE,R,H,3,Same,1695
1787,2516,729,0.559151785,0.43654609,2338,1670,29,326,'01_09_04.c3d',23,EE,R,H,4,Same,668
1737,2656,919,0.38619943,0.366287828,2251,1261,1,315,'01_09_05.c3d',23,EE,R,H,5,Same,990
862,1038,176,1.53252793,0.975967411,464,394,246,1,'01_09_01.c3d',24,EE,R,H,1,Same,70
620,974,354,1.188490815,1.055946866,515,594,91,215,'01_09_02.c3d',24,EE,R,H,2,Same,79
1007,1045,38,1.189492719,1.076817429,474,419,62,21,'01_09_03.c3d',24,EE,R,H,3,Same,55
746,1176,430,1.286129457,0.932187426,547,504,329,104,'01_09_04.c3d',24,EE,R,H,4,Same,43
818,1229,411,1.369410644,0.66460295,477,459,1,36,'01_09_05.c3d',24,EE,R,H,5,Same,18
468,925,457,1.909026325,1.451404725,457,432,237,244,'01_09_01.c3d',25,EE,R,H,1,Same,25
688,1054,366,1.7230563,0.801597985,588,622,328,1,'01_09_02.c3d',25,EE,R,H,2,Same,34
503,942,439,1.32039726,1.062730824,436,396,215,199,'01_09_03.c3d',25,EE,R,H,3,Same,40
522,1033,511,1.426500385,1.293506254,514,450,237,261,'01_09_04.c3d',25,EE,R,H,4,Same,64
653,1791,1138,0.885418179,0.793797319,513,431,277,262,'01_09_05.c3d',25,EE,R,H,5,Same,82
680,1961,1281,1.026373533,1.080139328,572,499,83,1,'01_09_01.c3d',26,EE,R,H,1,Same,73
1659,1692,33,0.91484677,0.491735438,483,427,284,29,'01_09_02.c3d',26,EE,R,H,2,Same,56
1014,1027,13,1.067612056,0.832206208,474,431,281,12,'01_09_03.c3d',26,EE,R,H,3,Same,43
1023,5495,4472,0.907678306,0.579902493,500,435,38,1,'01_09_04.c3d',26,EE,R,H,4,Same,65
1030,2238,1208,0.924999701,0.627242958,921,507,299,17,'01_09_05.c3d',26,EE,R,H,5,Same,414
1195,1708,513,1.390408351,1.067467875,816,817,611,607,'01_09_01.c3d',27,EE,R,H,1,Same,1
1194,1801,607,1.177546747,0.759978396,871,818,45,1,'01_09_02.c3d',27,EE,R,H,2,Same,53
1294,1825,531,0.754928793,0.610361993,748,1272,454,1,'01_09_03.c3d',27,EE,R,H,3,Same,524
939,1227,288,1.023506272,0.596576758,636,589,56,355,'01_09_04.c3d',27,EE,R,H,4,Same,47
1003,1466,463,0.871566683,0.838685249,625,585,31,1,'01_09_05.c3d',27,EE,R,H,5,Same,40
804,1945,1141,0.909781728,0.953708058,1146,643,835,1,'01_09_01.c3d',28,EE,R,H,1,Same,503
1178,1559,381,0.776608997,0.481441064,1118,728,322,358,'01_09_02.c3d',28,EE,R,H,2,Same,390
1266,1314,48,1.057459402,0.546512734,836,646,1,4,'01_09_03.c3d',28,EE,R,H,3,Same,190
1312,1610,298,0.599630578,0.466782325,699,565,23,303,'01_09_04.c3d',28,EE,R,H,4,Same,134
1075,1142,67,0.888660188,0.570137882,785,1002,67,1,'01_09_05.c3d',28,EE,R,H,5,Same,217
529,1237,708,1.421052411,1.44230437,496,453,291,1,'01_09_01.c3d',29,EE,R,H,1,Same,43
491,1292,801,1.735470299,1.71770376,472,443,1,1,'01_09_02.c3d',29,EE,R,H,2,Same,29
1068,1977,909,0.914564987,0.959479329,548,516,309,25,'01_09_03.c3d',29,EE,R,H,3,Same,32
963,1363,400,1.196750249,0.849806761,490,440,79,230,'01_09_04.c3d',29,EE,R,H,4,Same,50
902,1037,135,1.259281374,1.094086445,577,473,1,1,'01_09_05.c3d',29,EE,R,H,5,Same,104
2014,2112,98,0.715314599,0.647195251,756,727,1,1,'01_09_01.c3d',30,EE,R,H,1,Same,29
806,1771,965,1.34700847,1.580545791,671,629,458,458,'01_09_02.c3d',30,EE,R,H,2,Same,42
953,1635,682,0.992155287,1.050620937,512,480,55,318,'01_09_03.c3d',30,EE,R,H,3,Same,32
658,1320,662,0.951328518,0.927726293,469,438,240,59,'01_09_04.c3d',30,EE,R,H,4,Same,31
938,1428,490,0.790276026,0.791042547,805,495,1,1,'01_09_05.c3d',30,EE,R,H,5,Same,310
794,1012,218,1.771439979,1.143651562,478,449,269,274,'01_09_01.c3d',31,EE,R,H,1,Same,29
854,963,109,1.567130688,0.998214061,543,473,302,91,'01_09_02.c3d',31,EE,R,H,2,Same,70
911,930,19,1.839018813,1.066159141,497,431,287,30,'01_09_03.c3d',31,EE,R,H,3,Same,66
828,2001,1173,1.823260734,1.358065292,462,416,266,264,'01_09_04.c3d',31,EE,R,H,4,Same,46
587,942,355,1.976422783,1.277772022,506,471,294,265,'01_09_05.c3d',31,EE,R,H,5,Same,35
1885,2438,553,0.888105343,0.584865259,767,469,46,1,'01_09_01.c3d',32,EE,R,H,1,Same,298
722,1133,411,1.194379697,0.718328663,498,570,285,265,'01_09_02.c3d',32,EE,R,H,2,Same,72
865,1320,455,1.366300596,0.808424626,492,468,281,1,'01_09_03.c3d',32,EE,R,H,3,Same,24
1058,1169,111,1.053764333,0.615582281,619,673,66,1,'01_09_04.c3d',32,EE,R,H,4,Same,54
1108,1441,333,1.211700817,0.64083885,845,481,319,1,'01_09_05.c3d',32,EE,R,H,5,Same,364
924,1317,393,0.883382008,0.662955713,953,689,392,1,'01_09_01.c3d',33,EE,R,H,1,Same,264
1014,1314,300,1.033169096,0.820181428,582,581,52,317,'01_09_02.c3d',33,EE,R,H,2,Same,1
746,1508,762,1.454438242,0.93147408,686,621,403,15,'01_09_03.c3d',33,EE,R,H,3,Same,65
857,1198,341,1.531463581,1.210247688,687,663,460,1,'01_09_04.c3d',33,EE,R,H,4,Same,24
710,1216,506,1.241819224,0.856795961,593,560,75,305,'01_09_05.c3d',33,EE,R,H,5,Same,33
1079,1735,656,0.936459826,0.743420351,710,649,486,1,'01_09_01.c3d',34,EE,R,H,1,Same,61
929,1589,660,1.516907262,0.594496621,738,864,468,1,'01_09_02.c3d',34,EE,R,H,2,Same,126
883,957,74,1.925890283,1.377842568,431,377,271,242,'01_09_03.c3d',34,EE,R,H,3,Same,54
581,1424,843,1.428786872,1.323775943,525,500,331,1,'01_09_04.c3d',34,EE,R,H,4,Same,25
620,1081,461,1.10405567,0.699284056,587,408,1,1,'01_09_05.c3d',34,EE,R,H,5,Same,179
990,1453,463,1.371205575,0.81970304,482,756,1,1,'01_09_01.c3d',35,EE,R,H,1,Same,274
419,900,481,1.590518591,0.747336412,473,420,1,1,'01_09_02.c3d',35,EE,R,H,2,Same,53
676,1177,501,1.492646158,0.887734652,583,593,290,298,'01_09_03.c3d',35,EE,R,H,3,Same,10
385,977,592,1.550589388,1.373432633,373,315,120,41,'01_09_04.c3d',35,EE,R,H,4,Same,58
950,1556,606,1.437355607,0.928902913,607,598,1,40,'01_09_05.c3d',35,EE,R,H,5,Same,9
1236,1345,109,0.803408638,0.926353135,895,1053,1,377,'01_10_01.c3d',1,VV,B,E,1,Same,158
1266,2106,840,1.049148972,0.891628693,848,877,1,1,'01_10_02.c3d',1,VV,B,E,2,Same,29
1331,1551,220,0.827030481,0.968488644,540,680,1,1,'01_10_03.c3d',1,VV,B,E,3,Same,140
1025,1063,38,0.98118335,0.958559076,736,836,234,259,'01_10_04.c3d',1,VV,B,E,4,Same,100
979,1005,26,1.063620289,1.065070221,913,833,300,264,'01_10_05.c3d',1,VV,B,E,5,Same,80
1194,1263,69,0.794278245,0.944853909,855,1143,306,262,'01_10_01.c3d',2,VV,B,E,1,Same,288
1384,1512,128,0.497953525,0.846174358,974,1090,1,1,'01_10_02.c3d',2,VV,B,E,2,Same,116
1332,1375,43,0.630831734,0.905023025,891,1107,280,1,'01_10_03.c3d',2,VV,B,E,3,Same,216
1423,2155,732,0.756429343,1.172804333,800,810,291,286,'01_10_04.c3d',2,VV,B,E,4,Same,10
1061,1402,341,0.892537559,1.019116407,812,1112,1,1,'01_10_05.c3d',2,VV,B,E,5,Same,300
676,725,49,1.417341178,1.924544863,517,666,230,171,'01_10_01.c3d',3,VV,B,E,1,Same,149
776,785,9,1.255416678,1.903929204,566,568,250,286,'01_10_02.c3d',3,VV,B,E,2,Same,2
759,797,38,1.289621425,1.598943109,532,740,281,276,'01_10_03.c3d',3,VV,B,E,3,Same,208
648,730,82,1.411058228,1.496807375,527,574,134,1,'01_10_04.c3d',3,VV,B,E,4,Same,47
859,953,94,0.971141213,1.294827987,576,700,1,262,'01_10_05.c3d',3,VV,B,E,5,Same,124
1069,1237,168,0.780406843,0.941143856,760,803,335,339,'01_10_01.c3d',4,VV,B,E,1,Same,43
1233,1252,19,0.817368926,0.860462871,973,946,1,1,'01_10_02.c3d',4,VV,B,E,2,Same,27
930,1392,462,0.983545626,1.095500458,599,662,186,141,'01_10_03.c3d',4,VV,B,E,3,Same,63
928,1004,76,0.982436597,1.040488292,728,767,230,320,'01_10_04.c3d',4,VV,B,E,4,Same,39
974,1015,41,0.848484343,0.971591016,700,755,157,1,'01_10_05.c3d',4,VV,B,E,5,Same,55
635,872,237,1.409412854,2.090751666,549,582,288,274,'01_10_01.c3d',5,VV,B,E,1,Same,33
929,1162,233,1.59108324,1.85497766,578,598,1,287,'01_10_02.c3d',5,VV,B,E,2,Same,20
656,693,37,1.898116059,1.89562579,579,611,1,273,'01_10_03.c3d',5,VV,B,E,3,Same,32
706,907,201,1.884531761,2.115590061,571,570,279,292,'01_10_04.c3d',5,VV,B,E,4,Same,1
736,861,125,1.754951608,1.916005643,657,582,1,267,'01_10_05.c3d',5,VV,B,E,5,Same,75
998,1488,490,1.069158508,1.277922564,805,1257,1,6,'01_10_01.c3d',6,VV,B,E,1,Same,452
1100,1163,63,0.932396388,1.078381997,906,886,1,1,'01_10_02.c3d',6,VV,B,E,2,Same,20
925,982,57,1.067102679,1.037056988,725,709,293,1,'01_10_03.c3d',6,VV,B,E,3,Same,16
869,1029,160,0.979938938,1.129245152,685,682,259,246,'01_10_04.c3d',6,VV,B,E,4,Same,3
1201,1336,135,0.901883187,1.069346601,821,818,1,342,'01_10_05.c3d',6,VV,B,E,5,Same,3
971,1037,66,0.917416573,0.732344056,678,723,31,290,'01_10_01.c3d',7,VV,B,E,1,Same,45
956,1033,77,0.962795314,0.976901115,663,705,312,1,'01_10_02.c3d',7,VV,B,E,2,Same,42
916,974,58,0.944686447,0.974753211,733,727,29,303,'01_10_03.c3d',7,VV,B,E,3,Same,6
881,915,34,1.100589052,0.860670269,565,748,201,1,'01_10_04.c3d',7,VV,B,E,4,Same,183
773,1662,889,1.003854056,0.991685045,576,585,235,163,'01_10_05.c3d',7,VV,B,E,5,Same,9
1212,1847,635,0.851292291,1.050426083,813,739,1,350,'01_10_01.c3d',8,VV,B,E,1,Same,74
1074,1343,269,0.801555644,0.984235141,674,696,257,1,'01_10_02.c3d',8,VV,B,E,2,Same,22
1630,1724,94,0.496698682,0.520642697,792,946,283,1,'01_10_03.c3d',8,VV,B,E,3,Same,154
1397,1865,468,0.796690824,0.8430144,750,818,368,375,'01_10_04.c3d',8,VV,B,E,4,Same,68
1456,1779,323,0.639208197,0.869758102,873,895,1,1,'01_10_05.c3d',8,VV,B,E,5,Same,22
910,1366,456,0.914238248,1.087313464,578,575,247,240,'01_10_01.c3d',9,VV,B,E,1,Same,3
989,1327,338,0.905040305,0.973143454,602,583,1,1,'01_10_02.c3d',9,VV,B,E,2,Same,19
812,1317,505,1.05527196,1.338036387,672,612,267,257,'01_10_03.c3d',9,VV,B,E,3,Same,60
1247,2327,1080,0.721268872,0.712836769,683,791,107,85,'01_10_04.c3d',9,VV,B,E,4,Same,108
1367,1750,383,0.557485083,0.623854993,721,743,285,266,'01_10_05.c3d',9,VV,B,E,5,Same,22
887,1459,572,0.912947099,1.19473707,542,636,1,53,'01_10_01.c3d',10,VV,B,E,1,Same,94
830,1487,657,1.022717967,1.208963563,553,536,104,1,'01_10_02.c3d',10,VV,B,E,2,Same,17
768,1512,744,0.977173771,1.188116597,426,535,1,11,'01_10_03.c3d',10,VV,B,E,3,Same,109
911,1251,340,1.217243437,1.470422791,663,675,238,242,'01_10_04.c3d',10,VV,B,E,4,Same,12
890,1360,470,1.093818099,1.255041408,408,416,27,1,'01_10_05.c3d',10,VV,B,E,5,Same,8
1424,2295,871,0.772097194,0.806858067,892,1036,1,1,'01_10_01.c3d',11,VV,B,E,1,Same,144
1297,1443,146,0.74991313,0.817125136,1011,1029,525,1,'01_10_02.c3d',11,VV,B,E,2,Same,18
1452,1517,65,0.615711834,0.635974305,1126,1207,1,395,'01_10_03.c3d',11,VV,B,E,3,Same,81
1857,1914,57,0.458453359,0.579927571,1596,1548,397,413,'01_10_04.c3d',11,VV,B,E,4,Same,48
1166,1279,113,0.65842403,0.814445723,910,862,299,280,'01_10_05.c3d',11,VV,B,E,5,Same,48
765,812,47,1.264053377,1.506328789,644,682,296,308,'01_10_01.c3d',12,VV,B,E,1,Same,38
1037,1083,46,0.961298712,1.136379948,768,829,1,391,'01_10_02.c3d',12,VV,B,E,2,Same,61
930,963,33,1.035670262,1.073643695,805,824,358,359,'01_10_03.c3d',12,VV,B,E,3,Same,19
857,902,45,1.42221781,1.355090232,627,657,272,303,'01_10_04.c3d',12,VV,B,E,4,Same,30
877,947,70,0.845757502,0.980371169,522,684,98,95,'01_10_05.c3d',12,VV,B,E,5,Same,162
1031,1043,12,1.131603784,1.198593855,825,874,30,1,'01_10_01.c3d',13,VV,B,E,1,Same,49
1638,1729,91,1.044443874,1.139777695,767,827,1,1,'01_10_02.c3d',13,VV,B,E,2,Same,60
958,966,8,1.108519731,1.093254662,753,757,277,275,'01_10_03.c3d',13,VV,B,E,3,Same,4
834,852,18,1.302026431,1.143676455,622,702,146,1,'01_10_04.c3d',13,VV,B,E,4,Same,80
898,943,45,1.277153563,1.22708591,679,704,309,1,'01_10_05.c3d',13,VV,B,E,5,Same,25
889,1880,991,1.241191694,0.956279963,710,779,1,1,'01_10_01.c3d',14,VV,B,E,1,Same,69
707,715,8,1.74577072,1.890834388,541,587,1,31,'01_10_02.c3d',14,VV,B,E,2,Same,46
696,1236,540,1.421026437,2.005336344,552,563,1,1,'01_10_03.c3d',14,VV,B,E,3,Same,11
637,750,113,1.742132849,1.586254459,412,511,1,1,'01_10_04.c3d',14,VV,B,E,4,Same,99
677,701,24,1.369161684,1.715664936,582,564,143,1,'01_10_05.c3d',14,VV,B,E,5,Same,18
964,966,2,1.23546842,1.371623611,664,741,332,169,'01_10_01.c3d',15,VV,B,E,1,Same,77
909,961,52,1.186409896,1.30065796,688,712,259,281,'01_10_02.c3d',15,VV,B,E,2,Same,24
866,875,9,1.043243655,1.147954086,646,684,118,1,'01_10_03.c3d',15,VV,B,E,3,Same,38
818,886,68,1.186107594,1.20605079,634,696,206,233,'01_10_04.c3d',15,VV,B,E,4,Same,62
1037,1419,382,0.932653001,1.250403852,840,779,306,1,'01_10_05.c3d',15,VV,B,E,5,Same,61
995,1194,199,0.989221578,1.279267722,767,746,343,344,'01_10_01.c3d',16,VV,B,E,1,Same,21
730,974,244,1.113712813,1.71920142,692,604,262,258,'01_10_02.c3d',16,VV,B,E,2,Same,88
1676,2055,379,1.279363402,1.262339627,1483,1500,132,162,'01_10_03.c3d',16,VV,B,E,3,Same,17
749,1557,808,1.128369172,1.228629862,686,548,101,20,'01_10_04.c3d',16,VV,B,E,4,Same,138
1063,1067,4,0.945269391,1.175333651,683,783,372,1,'01_10_05.c3d',16,VV,B,E,5,Same,100
648,700,52,1.731920011,2.229617213,577,588,341,1,'01_10_01.c3d',17,VV,B,E,1,Same,11
608,638,30,1.654152793,1.790637181,502,506,231,239,'01_10_02.c3d',17,VV,B,E,2,Same,4
567,675,108,2.093609026,1.698069746,490,439,265,269,'01_10_03.c3d',17,VV,B,E,3,Same,51
586,600,14,2.413654685,2.387203549,540,544,274,274,'01_10_04.c3d',17,VV,B,E,4,Same,4
563,599,36,2.810742841,2.502986085,547,569,284,289,'01_10_05.c3d',17,VV,B,E,5,Same,22
4342,5007,665,0.558657249,0.538414699,1666,1334,523,546,'01_10_01.c3d',18,VV,B,E,1,Same,332
921,924,3,1.224546065,1.307096425,595,594,343,356,'01_10_02.c3d',18,VV,B,E,2,Same,1
705,1995,1290,1.158807728,1.515780183,425,517,1,97,'01_10_03.c3d',18,VV,B,E,3,Same,92
962,1020,58,1.186670534,1.302456531,746,780,340,1,'01_10_04.c3d',18,VV,B,E,4,Same,34
556,636,80,0.896115947,1.179318176,451,455,1,1,'01_10_05.c3d',18,VV,B,E,5,Same,4
1265,1310,45,0.741097431,0.902315838,942,899,383,384,'01_10_01.c3d',19,VV,B,E,1,Same,43
1101,1626,525,0.893135396,0.933380639,843,668,274,303,'01_10_02.c3d',19,VV,B,E,2,Same,175
1020,1192,172,0.844363703,1.187675176,824,712,342,330,'01_10_03.c3d',19,VV,B,E,3,Same,112
836,868,32,1.096462591,1.279115804,731,605,1,229,'01_10_04.c3d',19,VV,B,E,4,Same,126
1267,1422,155,0.824658212,1.212114672,719,716,1,310,'01_10_05.c3d',19,VV,B,E,5,Same,3
911,1621,710,0.960504589,1.172525513,728,779,269,1,'01_10_01.c3d',20,VV,B,E,1,Same,51
998,1054,56,0.953983779,1.139582183,761,656,323,1,'01_10_02.c3d',20,VV,B,E,2,Same,105
970,1077,107,1.107886619,1.201355723,714,764,372,1,'01_10_03.c3d',20,VV,B,E,3,Same,50
894,975,81,1.061728859,1.265358247,717,658,270,263,'01_10_04.c3d',20,VV,B,E,4,Same,59
960,998,38,1.002731296,1.033171015,627,695,1,227,'01_10_05.c3d',20,VV,B,E,5,Same,68
1166,1170,4,0.831715497,0.889049135,1013,992,376,370,'01_10_01.c3d',21,VV,B,E,1,Same,21
1220,1521,301,0.78010543,0.892701416,872,963,386,374,'01_10_02.c3d',21,VV,B,E,2,Same,91
995,998,3,1.141821519,1.154978417,844,686,1,338,'01_10_03.c3d',21,VV,B,E,3,Same,158
1308,1440,132,0.670435107,0.719090208,796,745,1,1,'01_10_04.c3d',21,VV,B,E,4,Same,51
1020,1799,779,0.956004157,0.837447345,795,841,1,1,'01_10_05.c3d',21,VV,B,E,5,Same,46
1056,1122,66,0.888176043,1.415998481,677,881,314,349,'01_10_01.c3d',22,VV,B,E,1,Same,204
1083,1499,416,0.883236855,1.674584749,770,951,299,462,'01_10_02.c3d',22,VV,B,E,2,Same,181
1172,1519,347,0.923947813,1.162189444,814,853,346,367,'01_10_03.c3d',22,VV,B,E,3,Same,39
1204,1289,85,0.783872811,1.3415097,913,918,301,395,'01_10_04.c3d',22,VV,B,E,4,Same,5
1431,1880,449,0.651250994,1.108701943,1061,943,305,385,'01_10_05.c3d',22,VV,B,E,5,Same,118
2382,4986,2604,0.478641984,0.45591903,1089,1149,1,1,'01_10_01.c3d',23,VV,B,E,1,Same,60
2945,4158,1213,0.70663741,0.675330671,904,938,396,342,'01_10_02.c3d',23,VV,B,E,2,Same,34
1545,2328,783,0.492544068,0.619476865,1064,882,255,252,'01_10_03.c3d',23,VV,B,E,3,Same,182
1725,2081,356,0.480402209,0.616107181,855,842,1,257,'01_10_04.c3d',23,VV,B,E,4,Same,13
2955,3211,256,0.379431994,0.346743935,1559,1956,1,1,'01_10_05.c3d',23,VV,B,E,5,Same,397
1276,1455,179,0.972334014,0.898271858,766,786,333,335,'01_10_01.c3d',24,VV,B,E,1,Same,20
928,973,45,1.028251634,1.137249299,606,693,271,270,'01_10_02.c3d',24,VV,B,E,2,Same,87
933,942,9,0.915878965,0.937039844,703,589,209,36,'01_10_03.c3d',24,VV,B,E,3,Same,114
944,954,10,1.148687056,1.231490605,685,698,288,284,'01_10_04.c3d',24,VV,B,E,4,Same,13
848,941,93,1.126363289,1.020714053,639,693,1,1,'01_10_05.c3d',24,VV,B,E,5,Same,54
1638,1894,256,0.85743974,0.885068373,848,577,442,437,'01_10_01.c3d',25,VV,B,E,1,Same,271
1279,1369,90,0.703809148,0.788619504,856,808,1,349,'01_10_02.c3d',25,VV,B,E,2,Same,48
1052,1241,189,0.978584167,0.813330625,729,733,286,272,'01_10_03.c3d',25,VV,B,E,3,Same,4
891,1506,615,1.184452885,1.230250762,658,600,275,277,'01_10_04.c3d',25,VV,B,E,4,Same,58
857,916,59,1.163201134,1.039469373,621,564,245,252,'01_10_05.c3d',25,VV,B,E,5,Same,57
1808,2192,384,0.643718994,0.832113423,1053,791,270,277,'01_10_01.c3d',26,VV,B,E,1,Same,262
1875,2258,383,0.838529195,0.554081011,813,1222,296,1,'01_10_02.c3d',26,VV,B,E,2,Same,409
1568,2698,1130,0.580443548,0.641456508,1469,995,623,503,'01_10_03.c3d',26,VV,B,E,3,Same,474
919,958,39,0.850845022,0.905148918,763,691,221,199,'01_10_04.c3d',26,VV,B,E,4,Same,72
1440,1524,84,0.558970151,0.589093553,1096,926,261,263,'01_10_05.c3d',26,VV,B,E,5,Same,170
1157,1254,97,1.147339894,1.286327518,849,912,518,489,'01_10_01.c3d',27,VV,B,E,1,Same,63
1172,1217,45,1.057031324,1.298931879,969,946,464,457,'01_10_02.c3d',27,VV,B,E,2,Same,23
1967,2685,718,0.655807801,0.811528201,1023,1083,463,1,'01_10_03.c3d',27,VV,B,E,3,Same,60
1334,1348,14,0.837712556,0.944803476,942,1112,420,1,'01_10_04.c3d',27,VV,B,E,4,Same,170
1385,1685,300,0.863698784,1.150022489,890,906,403,379,'01_10_05.c3d',27,VV,B,E,5,Same,16
1570,1914,344,0.815147655,0.705866031,918,1496,256,555,'01_10_01.c3d',28,VV,B,E,1,Same,578
1232,1388,156,0.728964127,0.819576393,781,955,1,339,'01_10_02.c3d',28,VV,B,E,2,Same,174
1385,1553,168,0.788278491,0.836153426,1182,1097,1,473,'01_10_03.c3d',28,VV,B,E,3,Same,85
1235,1428,193,0.807353626,0.850197533,915,886,269,1,'01_10_04.c3d',28,VV,B,E,4,Same,29
2086,2513,427,0.705936047,0.643426354,1527,1570,947,1,'01_10_05.c3d',28,VV,B,E,5,Same,43
914,1985,1071,1.934211678,1.763095669,756,749,431,431,'01_10_01.c3d',29,VV,B,E,1,Same,7
1129,1903,774,0.845771645,1.187511292,804,786,1,372,'01_10_02.c3d',29,VV,B,E,2,Same,18
947,980,33,0.940171653,1.164876691,700,745,1,289,'01_10_03.c3d',29,VV,B,E,3,Same,45
862,875,13,1.110412396,1.255087796,612,637,1,1,'01_10_04.c3d',29,VV,B,E,4,Same,25
1104,1942,838,0.757176008,0.990075545,760,693,276,1,'01_10_05.c3d',29,VV,B,E,5,Same,67
788,1076,288,1.183745325,1.12172366,652,637,249,1,'01_10_01.c3d',30,VV,B,E,1,Same,15
854,905,51,1.294048318,1.179120808,644,644,1,309,'01_10_02.c3d',30,VV,B,E,2,Same,0
939,1051,112,0.683659279,0.729752844,765,598,90,71,'01_10_03.c3d',30,VV,B,E,3,Same,167
953,997,44,0.947105268,0.801949364,705,749,1,225,'01_10_04.c3d',30,VV,B,E,4,Same,44
1232,1370,138,0.627993021,0.57770349,694,728,64,1,'01_10_05.c3d',30,VV,B,E,5,Same,34
816,846,30,2.083196585,1.882401893,671,637,312,1,'01_10_01.c3d',31,VV,B,E,1,Same,34
840,931,91,1.628084464,1.858504087,650,633,309,309,'01_10_02.c3d',31,VV,B,E,2,Same,17
984,1000,16,1.463750762,1.450043507,753,717,314,276,'01_10_03.c3d',31,VV,B,E,3,Same,36
830,849,19,1.890032483,2.005898911,652,671,312,306,'01_10_04.c3d',31,VV,B,E,4,Same,19
864,1558,694,1.37735202,1.607844155,587,645,259,271,'01_10_05.c3d',31,VV,B,E,5,Same,58
1041,1180,139,1.081357992,1.319147483,917,951,515,1,'01_10_01.c3d',32,VV,B,E,1,Same,34
1273,1323,50,0.982949496,1.137759144,853,898,353,355,'01_10_02.c3d',32,VV,B,E,2,Same,45
1064,1100,36,0.977525521,1.145547832,705,801,1,265,'01_10_03.c3d',32,VV,B,E,3,Same,96
952,956,4,1.0863891,1.201993195,819,816,311,297,'01_10_04.c3d',32,VV,B,E,4,Same,3
1077,1148,71,0.905152121,1.164101478,789,953,350,1,'01_10_05.c3d',32,VV,B,E,5,Same,164
1265,1820,555,0.65185871,1.028581226,963,997,35,1,'01_10_01.c3d',33,VV,B,E,1,Same,34
1190,1305,115,0.917428698,1.050977373,1002,968,421,1,'01_10_02.c3d',33,VV,B,E,2,Same,34
1351,1418,67,0.990718597,1.185013609,1131,1195,604,567,'01_10_03.c3d',33,VV,B,E,3,Same,64
1130,1996,866,0.916963192,1.163202383,953,1056,1,388,'01_10_04.c3d',33,VV,B,E,4,Same,103
1392,1417,25,0.77327678,0.893494417,1175,1179,350,348,'01_10_05.c3d',33,VV,B,E,5,Same,4
712,792,80,1.274162948,1.570261368,591,584,268,256,'01_10_01.c3d',34,VV,B,E,1,Same,7
759,878,119,1.069573412,1.233544236,559,551,252,245,'01_10_02.c3d',34,VV,B,E,2,Same,8
808,842,34,1.320902689,1.390626986,696,698,346,341,'01_10_03.c3d',34,VV,B,E,3,Same,2
684,730,46,1.310440753,1.46033843,582,576,248,234,'01_10_04.c3d',34,VV,B,E,4,Same,6
684,724,40,1.393030451,1.502687694,557,542,239,226,'01_10_05.c3d',34,VV,B,E,5,Same,15
828,831,3,1.302163854,1.240228325,609,672,88,214,'01_10_01.c3d',35,VV,B,E,1,Same,63
835,947,112,1.413190484,1.080969822,697,747,207,1,'01_10_02.c3d',35,VV,B,E,2,Same,50
909,954,45,1.199836623,1.113113103,692,695,168,178,'01_10_03.c3d',35,VV,B,E,3,Same,3
783,1331,548,1.405334012,1.188951881,536,583,1,1,'01_10_04.c3d',35,VV,B,E,4,Same,47
910,1079,169,1.095923684,1.031350223,657,611,1,141,'01_10_05.c3d',35,VV,B,E,5,Same,46
1315,1488,173,0.732747796,0.731226999,963,1134,1,284,'01_11_01.c3d',1,VV,B,M,1,Same,171
1205,1375,170,0.870265537,0.744264322,856,1022,348,357,'01_11_02.c3d',1,VV,B,M,2,Same,166
771,797,26,0.808407161,1.072990509,536,654,1,1,'01_11_03.c3d',1,VV,B,M,3,Same,118
1239,1271,32,0.776885296,0.825003437,1052,1021,1,1,'01_11_04.c3d',1,VV,B,M,4,Same,31
1213,1513,300,1.070475456,0.908115916,1016,1086,466,1,'01_11_05.c3d',1,VV,B,M,5,Same,70
1725,2086,361,0.598573108,0.981884289,1541,984,249,1,'01_11_01.c3d',2,VV,B,M,1,Same,557
1443,2024,581,0.640708866,0.771503437,1067,1235,309,28,'01_11_02.c3d',2,VV,B,M,2,Same,168
992,1191,199,0.826173152,0.980257206,700,831,1,1,'01_11_03.c3d',2,VV,B,M,3,Same,131
1707,1773,66,0.593721694,0.642293757,855,1101,1,1,'01_11_04.c3d',2,VV,B,M,4,Same,246
1802,1875,73,0.406861243,0.674952558,1291,1405,264,278,'01_11_05.c3d',2,VV,B,M,5,Same,114
833,840,7,1.019740121,1.41513714,565,657,1,240,'01_11_01.c3d',3,VV,B,M,1,Same,92
726,815,89,1.277122413,1.347128088,581,656,241,236,'01_11_02.c3d',3,VV,B,M,2,Same,75
795,806,11,1.194576594,1.45517447,624,745,1,1,'01_11_03.c3d',3,VV,B,M,3,Same,121
894,966,72,1.200240684,1.227776783,635,735,306,1,'01_11_04.c3d',3,VV,B,M,4,Same,100
933,1044,111,1.022805846,1.094444507,574,931,218,1,'01_11_05.c3d',3,VV,B,M,5,Same,357
1125,1338,213,0.903007145,0.916363854,785,906,430,1,'01_11_01.c3d',4,VV,B,M,1,Same,121
981,1046,65,0.976297095,1.006023578,649,702,294,249,'01_11_02.c3d',4,VV,B,M,2,Same,53
1096,1110,14,0.871308394,0.978426842,918,990,1,1,'01_11_03.c3d',4,VV,B,M,3,Same,72
925,955,30,0.991569571,1.125763982,761,731,1,1,'01_11_04.c3d',4,VV,B,M,4,Same,30
936,1079,143,0.934232124,0.953275909,750,869,1,322,'01_11_05.c3d',4,VV,B,M,5,Same,119
844,1702,858,1.554232644,1.723018926,707,716,416,1,'01_11_01.c3d',5,VV,B,M,1,Same,9
711,779,68,1.604228961,1.895546138,558,645,289,1,'01_11_02.c3d',5,VV,B,M,2,Same,87
647,773,126,1.573861508,1.497003207,464,447,197,1,'01_11_03.c3d',5,VV,B,M,3,Same,17
759,772,13,1.427006518,1.673075639,585,593,1,1,'01_11_04.c3d',5,VV,B,M,4,Same,8
767,952,185,1.308077299,1.8134797,651,481,253,257,'01_11_05.c3d',5,VV,B,M,5,Same,170
1265,1751,486,0.911277049,1.035245229,1091,770,362,1,'01_11_01.c3d',6,VV,B,M,1,Same,321
958,1015,57,0.994059167,1.042989793,695,768,275,1,'01_11_02.c3d',6,VV,B,M,2,Same,73
1151,1171,20,0.86645654,0.931781172,764,724,1,304,'01_11_03.c3d',6,VV,B,M,3,Same,40
1067,1142,75,0.872600569,0.989569273,696,710,280,1,'01_11_04.c3d',6,VV,B,M,4,Same,14
1026,1089,63,1.012406501,0.976104228,717,826,1,1,'01_11_05.c3d',6,VV,B,M,5,Same,109
1166,1175,9,0.810903499,0.688748936,801,871,1,1,'01_11_01.c3d',7,VV,B,M,1,Same,70
1076,1115,39,0.786406569,0.712698369,711,862,1,1,'01_11_02.c3d',7,VV,B,M,2,Same,151
906,941,35,0.991057074,0.890880886,670,665,268,253,'01_11_03.c3d',7,VV,B,M,3,Same,5
900,1776,876,1.019382662,0.773534343,690,704,268,55,'01_11_04.c3d',7,VV,B,M,4,Same,14
947,1011,64,0.883717021,0.824497583,573,617,237,231,'01_11_05.c3d',7,VV,B,M,5,Same,44
1363,1656,293,0.511397789,0.85711923,856,942,344,349,'01_11_01.c3d',8,VV,B,M,1,Same,86
1396,1492,96,0.696033203,0.833452749,907,863,371,37,'01_11_02.c3d',8,VV,B,M,2,Same,44
1527,1676,149,0.490012956,0.566519424,673,920,1,251,'01_11_03.c3d',8,VV,B,M,3,Same,247
1312,1593,281,0.546796154,0.73369024,829,889,1,223,'01_11_04.c3d',8,VV,B,M,4,Same,60
1742,1806,64,0.451623238,0.565125493,898,925,1,1,'01_11_05.c3d',8,VV,B,M,5,Same,27
1465,2087,622,0.623615956,0.82461361,1619,1181,1,352,'01_11_01.c3d',9,VV,B,M,1,Same,438
981,1868,887,0.598920633,1.010186324,671,567,1,259,'01_11_02.c3d',9,VV,B,M,2,Same,104
1534,2140,606,0.80254949,1.144034435,1270,1254,1,1,'01_11_03.c3d',9,VV,B,M,3,Same,16
1176,1269,93,0.745701186,0.748494255,540,670,1,1,'01_11_04.c3d',9,VV,B,M,4,Same,130
1804,2012,208,0.889194785,0.946752061,684,741,269,264,'01_11_05.c3d',9,VV,B,M,5,Same,57
963,1628,665,0.983037951,1.271700764,746,730,1,262,'01_11_01.c3d',10,VV,B,M,1,Same,16
857,863,6,1.019784396,1.209686924,584,616,40,1,'01_11_02.c3d',10,VV,B,M,2,Same,32
946,964,18,1.090104864,1.422462205,701,698,259,243,'01_11_03.c3d',10,VV,B,M,3,Same,3
879,903,24,1.320631615,1.645489941,592,588,298,281,'01_11_04.c3d',10,VV,B,M,4,Same,4
804,1245,441,0.856980271,1.106658552,576,467,104,1,'01_11_05.c3d',10,VV,B,M,5,Same,109
1059,1152,93,0.814479664,0.958408668,799,863,67,1,'01_11_01.c3d',11,VV,B,M,1,Same,64
1598,1711,113,0.556118661,0.621840302,1412,1476,1,1,'01_11_02.c3d',11,VV,B,M,2,Same,64
1451,1486,35,0.57803978,0.687195388,1110,1221,335,371,'01_11_03.c3d',11,VV,B,M,3,Same,111
1158,1289,131,0.677870015,0.894565694,943,1017,321,1,'01_11_04.c3d',11,VV,B,M,4,Same,74
1516,1538,22,0.565983632,0.661086463,1123,1173,397,1,'01_11_05.c3d',11,VV,B,M,5,Same,50
1011,1061,50,0.976303117,0.999910483,716,744,1,293,'01_11_01.c3d',12,VV,B,M,1,Same,28
1106,1145,39,0.860171476,0.892726662,699,779,287,275,'01_11_02.c3d',12,VV,B,M,2,Same,80
942,958,16,0.94853545,1.163521036,592,703,284,295,'01_11_03.c3d',12,VV,B,M,3,Same,111
1155,1338,183,0.717686338,0.736470118,892,1006,320,339,'01_11_04.c3d',12,VV,B,M,4,Same,114
944,1008,64,0.963429,0.999569224,677,688,267,247,'01_11_05.c3d',12,VV,B,M,5,Same,11
1481,1566,85,0.671944244,0.769244637,1072,1324,397,1,'01_11_01.c3d',13,VV,B,M,1,Same,252
1371,2702,1331,1.047423322,1.066202909,1208,1254,656,1,'01_11_02.c3d',13,VV,B,M,2,Same,46
873,1005,132,0.961336552,1.193406398,617,690,211,1,'01_11_03.c3d',13,VV,B,M,3,Same,73
909,941,32,1.117427887,1.162107403,652,692,216,177,'01_11_04.c3d',13,VV,B,M,4,Same,40
1009,1074,65,1.129330662,1.344384514,853,872,381,1,'01_11_05.c3d',13,VV,B,M,5,Same,19
851,976,125,1.173390733,1.264576071,696,731,1,271,'01_11_01.c3d',14,VV,B,M,1,Same,35
717,758,41,1.283075304,1.499697352,503,519,1,211,'01_11_02.c3d',14,VV,B,M,2,Same,16
727,887,160,1.283178396,1.449220474,492,486,129,168,'01_11_03.c3d',14,VV,B,M,3,Same,6
803,891,88,1.199545125,1.247759469,631,612,228,85,'01_11_04.c3d',14,VV,B,M,4,Same,19
800,839,39,1.237472092,1.377225233,589,616,39,135,'01_11_05.c3d',14,VV,B,M,5,Same,27
872,1023,151,1.183397058,1.199490941,691,722,244,262,'01_11_01.c3d',15,VV,B,M,1,Same,31
982,1026,44,0.962236327,0.995166104,653,864,231,159,'01_11_02.c3d',15,VV,B,M,2,Same,211
914,1023,109,1.049275057,1.15873133,673,831,251,1,'01_11_03.c3d',15,VV,B,M,3,Same,158
878,907,29,1.066527611,1.191047423,714,620,220,137,'01_11_04.c3d',15,VV,B,M,4,Same,94
1009,1057,48,1.007689823,1.120546307,789,829,286,294,'01_11_05.c3d',15,VV,B,M,5,Same,40
920,1780,860,1.140622847,1.389552573,616,711,276,271,'01_11_01.c3d',16,VV,B,M,1,Same,95
858,1914,1056,0.975315701,1.419234118,760,761,39,1,'01_11_02.c3d',16,VV,B,M,2,Same,1
1123,1193,70,0.937243348,1.213600492,840,649,1,248,'01_11_03.c3d',16,VV,B,M,3,Same,191
979,1044,65,0.887303515,1.042512053,781,773,1,1,'01_11_04.c3d',16,VV,B,M,4,Same,8
985,1290,305,0.991339406,1.293180985,797,616,276,301,'01_11_05.c3d',16,VV,B,M,5,Same,181
579,622,43,1.817271866,1.844142321,492,527,1,244,'01_11_01.c3d',17,VV,B,M,1,Same,35
654,766,112,1.516214767,1.438183081,457,450,259,260,'01_11_02.c3d',17,VV,B,M,2,Same,7
672,1249,577,1.755674287,1.656490703,503,519,266,271,'01_11_03.c3d',17,VV,B,M,3,Same,16
568,627,59,2.193477644,1.977013377,487,501,247,252,'01_11_04.c3d',17,VV,B,M,4,Same,14
622,696,74,1.947372082,2.003502372,525,528,272,275,'01_11_05.c3d',17,VV,B,M,5,Same,3
1096,1099,3,0.802030933,1.142467127,661,896,1,321,'01_11_01.c3d',18,VV,B,M,1,Same,235
821,836,15,1.189717195,1.532774379,518,714,23,1,'01_11_02.c3d',18,VV,B,M,2,Same,196
820,821,1,1.320789626,1.599333288,641,676,314,1,'01_11_03.c3d',18,VV,B,M,3,Same,35
854,2068,1214,1.058373516,1.012932737,699,693,1,1,'01_11_04.c3d',18,VV,B,M,4,Same,6
634,2693,2059,0.993731953,1.179495719,445,554,1,1,'01_11_05.c3d',18,VV,B,M,5,Same,109
1881,2022,141,0.599939967,0.725884811,1444,1408,694,1,'01_11_01.c3d',19,VV,B,M,1,Same,36
1609,1739,130,0.568033209,0.618781309,1138,1082,1,1,'01_11_02.c3d',19,VV,B,M,2,Same,56
1169,1577,408,0.703541753,0.811032241,892,846,1,331,'01_11_03.c3d',19,VV,B,M,3,Same,46
899,901,2,1.024917007,1.207959903,704,698,1,231,'01_11_04.c3d',19,VV,B,M,4,Same,6
1063,1429,366,0.695385811,0.840478324,841,651,245,245,'01_11_05.c3d',19,VV,B,M,5,Same,190
991,1137,146,0.832353313,1.154456032,854,861,318,322,'01_11_01.c3d',20,VV,B,M,1,Same,7
947,1042,95,0.943549675,1.103922028,749,732,286,274,'01_11_02.c3d',20,VV,B,M,2,Same,17
947,1042,95,0.932776649,1.183634481,734,752,296,1,'01_11_03.c3d',20,VV,B,M,3,Same,18
1214,1926,712,1.072096329,1.198029819,981,925,530,529,'01_11_04.c3d',20,VV,B,M,4,Same,56
1268,1593,325,0.727344059,0.801066369,828,667,1,1,'01_11_05.c3d',20,VV,B,M,5,Same,161
1131,1446,315,0.975636504,0.979032988,874,883,392,360,'01_11_01.c3d',21,VV,B,M,1,Same,9
1050,1062,12,0.789471673,0.837284821,632,737,262,258,'01_11_02.c3d',21,VV,B,M,2,Same,105
1331,1358,27,0.755056633,0.73033312,888,952,391,20,'01_11_03.c3d',21,VV,B,M,3,Same,64
1045,1175,130,0.792692523,0.775180412,743,804,1,235,'01_11_04.c3d',21,VV,B,M,4,Same,61
1158,1190,32,0.785087115,0.884874504,821,814,334,333,'01_11_05.c3d',21,VV,B,M,5,Same,7
1195,1232,37,0.769837618,1.271157941,932,942,323,361,'01_11_01.c3d',22,VV,B,M,1,Same,10
1291,1645,354,0.758947003,1.155828631,848,1053,1,375,'01_11_02.c3d',22,VV,B,M,2,Same,205
1183,1245,62,0.827866961,1.159522029,902,933,274,316,'01_11_03.c3d',22,VV,B,M,3,Same,31
1220,1299,79,0.914010508,1.176057944,984,1008,343,1,'01_11_04.c3d',22,VV,B,M,4,Same,24
1306,1365,59,0.780442745,1.27399125,952,955,300,351,'01_11_05.c3d',22,VV,B,M,5,Same,3
2017,3126,1109,0.422323396,0.45954852,1243,1037,1,282,'01_11_01.c3d',23,VV,B,M,1,Same,206
1617,1899,282,0.56296248,0.511343385,993,1335,288,280,'01_11_02.c3d',23,VV,B,M,2,Same,342
2419,2675,256,0.412453334,0.615035629,1286,1462,1,1,'01_11_03.c3d',23,VV,B,M,3,Same,176
2178,2276,98,0.436957551,0.553143207,1017,1400,1,8,'01_11_04.c3d',23,VV,B,M,4,Same,383
2897,3031,134,0.278398844,0.312330878,1227,1737,1,235,'01_11_05.c3d',23,VV,B,M,5,Same,510
867,1046,179,1.26573665,1.070380834,679,713,267,279,'01_11_01.c3d',24,VV,B,M,1,Same,34
1003,1564,561,0.902669828,1.096259753,735,766,256,278,'01_11_02.c3d',24,VV,B,M,2,Same,31
955,989,34,1.160749102,1.184297443,689,717,311,331,'01_11_03.c3d',24,VV,B,M,3,Same,28
982,1011,29,0.905413354,0.979039281,695,675,224,218,'01_11_04.c3d',24,VV,B,M,4,Same,20
891,940,49,1.049056499,1.033068289,631,669,195,1,'01_11_05.c3d',24,VV,B,M,5,Same,38
1308,1451,143,0.798105938,0.734619113,768,937,341,331,'01_11_01.c3d',25,VV,B,M,1,Same,169
783,855,72,1.43099169,1.356113419,613,539,299,301,'01_11_02.c3d',25,VV,B,M,2,Same,74
832,850,18,1.377402548,1.504935492,582,577,287,288,'01_11_03.c3d',25,VV,B,M,3,Same,5
1144,1169,25,0.906202105,0.948212091,798,871,320,343,'01_11_04.c3d',25,VV,B,M,4,Same,73
1065,1101,36,0.887392211,0.88230229,730,620,259,226,'01_11_05.c3d',25,VV,B,M,5,Same,110
1229,1302,73,0.660019295,0.631147763,1079,1118,397,1,'01_11_01.c3d',26,VV,B,M,1,Same,39
1131,1963,832,0.873875143,0.728278486,732,795,354,318,'01_11_02.c3d',26,VV,B,M,2,Same,63
1786,2947,1161,0.706542452,0.614857146,1651,1659,1,711,'01_11_03.c3d',26,VV,B,M,3,Same,8
2123,4228,2105,0.693158952,0.941515784,2175,1856,1,1,'01_11_04.c3d',26,VV,B,M,4,Same,319
1433,3053,1620,0.625972138,0.64177944,1049,784,233,246,'01_11_05.c3d',26,VV,B,M,5,Same,265
1309,1324,15,0.890696012,1.033040253,869,1016,485,1,'01_11_01.c3d',27,VV,B,M,1,Same,147
1305,1322,17,0.951053673,1.201833564,1059,1052,517,519,'01_11_02.c3d',27,VV,B,M,2,Same,7
1176,1501,325,0.823310758,1.062688633,871,871,1,369,'01_11_03.c3d',27,VV,B,M,3,Same,0
1503,1532,29,0.833320107,0.943026645,1001,994,406,1,'01_11_04.c3d',27,VV,B,M,4,Same,7
1728,1798,70,0.857552778,0.997720509,1345,1338,55,1,'01_11_05.c3d',27,VV,B,M,5,Same,7
2109,3138,1029,0.801584002,0.990124842,2840,1804,1,1,'01_11_01.c3d',28,VV,B,M,1,Same,1036
1210,2162,952,0.887011988,1.067332892,913,1961,1,1336,'01_11_02.c3d',28,VV,B,M,2,Same,1048
1802,2338,536,0.762702213,0.853168555,1432,1409,604,1,'01_11_03.c3d',28,VV,B,M,3,Same,23
1211,1656,445,0.834155193,0.901377162,883,958,260,1,'01_11_04.c3d',28,VV,B,M,4,Same,75
1518,1525,7,0.762784282,0.878407122,1197,1006,403,434,'01_11_05.c3d',28,VV,B,M,5,Same,191
803,1724,921,0.797622906,1.573441704,699,677,1,280,'01_11_01.c3d',29,VV,B,M,1,Same,22
883,914,31,0.90424051,1.119623063,684,748,1,1,'01_11_02.c3d',29,VV,B,M,2,Same,64
924,1024,100,0.860388914,1.017665757,661,696,1,1,'01_11_03.c3d',29,VV,B,M,3,Same,35
1091,1107,16,0.778429432,0.999618561,744,725,1,336,'01_11_04.c3d',29,VV,B,M,4,Same,19
1102,1122,20,0.713198031,0.840237376,771,763,1,1,'01_11_05.c3d',29,VV,B,M,5,Same,8
917,951,34,0.928674209,0.963160177,705,687,47,258,'01_11_01.c3d',30,VV,B,M,1,Same,18
1116,1126,10,0.853072837,0.765763426,758,645,254,1,'01_11_02.c3d',30,VV,B,M,2,Same,113
1078,1171,93,0.842754468,0.721008405,812,741,275,273,'01_11_03.c3d',30,VV,B,M,3,Same,71
1045,1359,314,0.691066004,0.58157891,666,568,1,106,'01_11_04.c3d',30,VV,B,M,4,Same,98
1200,1384,184,0.702438436,0.577609094,779,797,1,1,'01_11_05.c3d',30,VV,B,M,5,Same,18
997,1039,42,1.38981864,1.190280427,721,870,1,332,'01_11_01.c3d',31,VV,B,M,1,Same,149
906,966,60,1.539530688,1.394378041,743,657,296,293,'01_11_02.c3d',31,VV,B,M,2,Same,86
876,920,44,1.716317274,1.542966356,673,647,315,300,'01_11_03.c3d',31,VV,B,M,3,Same,26
958,964,6,1.363349087,1.432135211,723,664,307,302,'01_11_04.c3d',31,VV,B,M,4,Same,59
1002,1184,182,1.319096283,1.359699621,721,711,335,335,'01_11_05.c3d',31,VV,B,M,5,Same,10
1000,1178,178,0.854786958,1.091244904,779,876,1,277,'01_11_01.c3d',32,VV,B,M,1,Same,97
1146,1238,92,0.854476632,1.062975556,844,855,265,227,'01_11_02.c3d',32,VV,B,M,2,Same,11
1469,1522,53,0.591843421,0.870932088,1021,846,295,266,'01_11_03.c3d',32,VV,B,M,3,Same,175
1281,1421,140,0.878120851,1.086582458,1002,1021,364,346,'01_11_04.c3d',32,VV,B,M,4,Same,19
1246,1369,123,0.813708078,1.031630359,875,908,1,342,'01_11_05.c3d',32,VV,B,M,5,Same,33
1491,1537,46,0.723862726,0.897553604,1056,1127,1,388,'01_11_01.c3d',33,VV,B,M,1,Same,71
1716,1876,160,0.734805019,0.838218067,1486,1618,1,665,'01_11_02.c3d',33,VV,B,M,2,Same,132
1376,1415,39,0.992872352,1.051114808,1099,1061,1,1,'01_11_03.c3d',33,VV,B,M,3,Same,38
1082,1128,46,1.028314272,1.088702047,843,932,302,1,'01_11_04.c3d',33,VV,B,M,4,Same,89
1142,1238,96,0.929655017,1.020471925,957,995,333,314,'01_11_05.c3d',33,VV,B,M,5,Same,38
1499,1627,128,0.792733819,0.847556721,1206,1390,684,1,'01_11_01.c3d',34,VV,B,M,1,Same,184
937,998,61,1.210692537,1.097348834,650,854,355,336,'01_11_02.c3d',34,VV,B,M,2,Same,204
905,935,30,1.074278792,1.113928067,652,587,283,281,'01_11_03.c3d',34,VV,B,M,3,Same,65
956,1151,195,0.795582389,0.96002978,764,594,255,229,'01_11_04.c3d',34,VV,B,M,4,Same,170
1216,1307,91,0.909544399,0.957032768,999,872,1,447,'01_11_05.c3d',34,VV,B,M,5,Same,127
942,946,4,1.133381259,1.136190964,713,642,252,241,'01_11_01.c3d',35,VV,B,M,1,Same,71
986,1056,70,1.046833016,1.020321593,755,702,259,233,'01_11_02.c3d',35,VV,B,M,2,Same,53
915,976,61,1.143143436,1.094001145,618,687,248,253,'01_11_03.c3d',35,VV,B,M,3,Same,69
917,936,19,1.211104471,1.149109403,671,616,1,230,'01_11_04.c3d',35,VV,B,M,4,Same,55
1049,1536,487,0.976238955,1.02690589,707,749,241,1,'01_11_05.c3d',35,VV,B,M,5,Same,42
2167,3210,1043,0.434583081,0.626181035,2215,2167,1,328,'01_12_01.c3d',1,VV,B,H,1,Same,48
1239,1346,107,0.860343558,0.776716129,892,1092,312,297,'01_12_02.c3d',1,VV,B,H,2,Same,200
1282,2160,878,0.872665196,0.787005451,969,1993,416,1,'01_12_03.c3d',1,VV,B,H,3,Same,1024
2021,2762,741,0.971950897,0.820396827,1701,2095,1195,1,'01_12_04.c3d',1,VV,B,H,4,Same,394
1109,1343,234,0.948572675,0.782798098,871,904,98,186,'01_12_05.c3d',1,VV,B,H,5,Same,33
1412,1587,175,0.540130047,1.045412616,1065,1291,1,372,'01_12_01.c3d',2,VV,B,H,1,Same,226
1963,2069,106,0.403120861,0.702695733,1117,1362,1,79,'01_12_02.c3d',2,VV,B,H,2,Same,245
1401,1696,295,0.594447008,0.701073721,1005,1205,1,45,'01_12_03.c3d',2,VV,B,H,3,Same,200
1487,1604,117,0.565746173,0.878788051,940,1124,297,1,'01_12_04.c3d',2,VV,B,H,4,Same,184
1717,1852,135,0.520768636,0.773101031,1184,1385,1,278,'01_12_05.c3d',2,VV,B,H,5,Same,201
824,865,41,1.171206966,1.434166739,630,714,232,269,'01_12_01.c3d',3,VV,B,H,1,Same,84
913,1810,897,1.180875313,1.298255452,702,794,154,1,'01_12_02.c3d',3,VV,B,H,2,Same,92
857,870,13,0.976850803,1.206202002,546,696,1,1,'01_12_03.c3d',3,VV,B,H,3,Same,150
879,1257,378,1.025802529,1.448789729,654,827,299,320,'01_12_04.c3d',3,VV,B,H,4,Same,173
961,1008,47,1.078522233,1.213307144,622,652,1,1,'01_12_05.c3d',3,VV,B,H,5,Same,30
1113,1200,87,0.819381192,0.848426031,743,843,1,390,'01_12_01.c3d',4,VV,B,H,1,Same,100
991,1074,83,0.969108802,0.968149955,717,779,1,359,'01_12_02.c3d',4,VV,B,H,2,Same,62
1053,1064,11,0.982252597,1.060252098,790,818,431,401,'01_12_03.c3d',4,VV,B,H,3,Same,28
1073,1133,60,0.758240839,0.901831031,812,752,1,1,'01_12_04.c3d',4,VV,B,H,4,Same,60
1137,1179,42,0.645950826,0.819352424,807,792,1,1,'01_12_05.c3d',4,VV,B,H,5,Same,15
849,851,2,1.47462818,1.679877396,633,643,1,305,'01_12_01.c3d',5,VV,B,H,1,Same,10
913,1441,528,1.548890061,1.320165402,636,658,403,389,'01_12_02.c3d',5,VV,B,H,2,Same,22
664,1159,495,1.331530137,1.389968198,440,441,1,126,'01_12_03.c3d',5,VV,B,H,3,Same,1
677,754,77,1.872639482,1.66664887,558,529,305,294,'01_12_04.c3d',5,VV,B,H,4,Same,29
748,872,124,1.594579782,1.536540977,556,497,249,241,'01_12_05.c3d',5,VV,B,H,5,Same,59
1121,2186,1065,0.845552313,0.904498182,711,1867,1,1,'01_12_01.c3d',6,VV,B,H,1,Same,1156
1216,1463,247,0.895132905,0.764720408,848,949,1,1,'01_12_02.c3d',6,VV,B,H,2,Same,101
1238,1475,237,0.756485293,0.923433768,920,946,1,1,'01_12_03.c3d',6,VV,B,H,3,Same,26
967,1024,57,0.929226814,1.025634758,735,686,282,1,'01_12_04.c3d',6,VV,B,H,4,Same,49
1156,1226,70,0.836668197,0.816221397,806,726,1,1,'01_12_05.c3d',6,VV,B,H,5,Same,80
1248,1892,644,0.614831591,0.746397278,859,920,470,156,'01_12_01.c3d',7,VV,B,H,1,Same,61
1268,1409,141,0.687526864,0.559946381,890,1000,1,364,'01_12_02.c3d',7,VV,B,H,2,Same,110
966,981,15,0.883126266,0.801209341,669,666,236,1,'01_12_03.c3d',7,VV,B,H,3,Same,3
822,896,74,0.79916267,0.744704181,504,524,1,1,'01_12_04.c3d',7,VV,B,H,4,Same,20
974,1009,35,0.86179518,0.745458734,713,742,176,1,'01_12_05.c3d',7,VV,B,H,5,Same,29
1300,1565,265,0.592876176,0.774302506,815,813,170,193,'01_12_01.c3d',8,VV,B,H,1,Same,2
1457,1589,132,0.535205539,0.648890165,950,796,272,270,'01_12_02.c3d',8,VV,B,H,2,Same,154
2135,2207,72,0.72718313,0.833712037,1758,1774,1200,1,'01_12_03.c3d',8,VV,B,H,3,Same,16
1264,1464,200,0.606982795,0.747611749,669,863,1,1,'01_12_04.c3d',8,VV,B,H,4,Same,194
1467,1694,227,0.509904231,0.730037728,875,999,325,338,'01_12_05.c3d',8,VV,B,H,5,Same,124
1171,2205,1034,0.434585091,0.883785403,677,727,1,1,'01_12_01.c3d',9,VV,B,H,1,Same,50
1442,1558,116,0.860458037,1.00950066,636,571,264,262,'01_12_02.c3d',9,VV,B,H,2,Same,65
1339,2029,690,0.689506828,0.668484393,727,723,329,319,'01_12_03.c3d',9,VV,B,H,3,Same,4
1774,1840,66,0.679930506,0.546235083,1254,1424,513,512,'01_12_04.c3d',9,VV,B,H,4,Same,170
1172,1671,499,0.697375041,0.834384714,683,642,1,256,'01_12_05.c3d',9,VV,B,H,5,Same,41
981,1435,454,1.267224533,1.526420211,763,679,247,258,'01_12_01.c3d',10,VV,B,H,1,Same,84
1039,1363,324,0.962265277,1.176803294,760,637,301,290,'01_12_02.c3d',10,VV,B,H,2,Same,123
782,790,8,1.013521393,1.277082869,544,601,1,1,'01_12_03.c3d',10,VV,B,H,3,Same,57
1093,1125,32,0.894159984,1.100721516,772,771,244,1,'01_12_04.c3d',10,VV,B,H,4,Same,1
1017,1385,368,0.945781163,1.204906747,674,683,257,260,'01_12_05.c3d',10,VV,B,H,5,Same,9
1378,1404,26,0.645261543,0.754276498,956,961,1,1,'01_12_01.c3d',11,VV,B,H,1,Same,5
1596,1624,28,0.50200572,0.602352718,1168,1379,363,1,'01_12_02.c3d',11,VV,B,H,2,Same,211
1600,1604,4,0.544530522,0.631663259,1429,1386,375,1,'01_12_03.c3d',11,VV,B,H,3,Same,43
1540,1571,31,0.549196103,0.626519573,1389,1201,344,1,'01_12_04.c3d',11,VV,B,H,4,Same,188
1877,1982,105,0.586917548,0.646575639,1751,1652,753,700,'01_12_05.c3d',11,VV,B,H,5,Same,99
1167,1194,27,0.829300758,0.958842041,730,795,320,322,'01_12_01.c3d',12,VV,B,H,1,Same,65
1079,1397,318,0.659817794,0.925210605,726,764,332,317,'01_12_02.c3d',12,VV,B,H,2,Same,38
1086,1358,272,0.674024542,0.835373928,720,767,293,1,'01_12_03.c3d',12,VV,B,H,3,Same,47
1026,1087,61,0.854907879,0.921725083,735,735,250,271,'01_12_04.c3d',12,VV,B,H,4,Same,0
1834,1969,135,0.701074798,0.836796216,696,770,266,255,'01_12_05.c3d',12,VV,B,H,5,Same,74
1150,1389,239,0.896878254,0.800483308,789,917,294,1,'01_12_01.c3d',13,VV,B,H,1,Same,128
1155,1162,7,0.96314791,0.951907154,796,848,1,1,'01_12_02.c3d',13,VV,B,H,2,Same,52
1039,1057,18,0.96311321,0.984438201,748,796,231,1,'01_12_03.c3d',13,VV,B,H,3,Same,48
1102,1122,20,0.933761549,1.016032385,824,708,312,1,'01_12_04.c3d',13,VV,B,H,4,Same,116
796,851,55,1.037139752,1.129244498,636,636,1,1,'01_12_05.c3d',13,VV,B,H,5,Same,0
769,1336,567,1.216614284,1.356240207,640,681,231,239,'01_12_01.c3d',14,VV,B,H,1,Same,41
748,805,57,1.160875228,1.619836952,560,553,240,244,'01_12_02.c3d',14,VV,B,H,2,Same,7
691,740,49,1.115488575,1.463545184,513,522,1,1,'01_12_03.c3d',14,VV,B,H,3,Same,9
892,910,18,1.17953674,1.131694815,482,663,189,1,'01_12_04.c3d',14,VV,B,H,4,Same,181
1106,1653,547,1.051418847,1.06446228,786,739,1,358,'01_12_05.c3d',14,VV,B,H,5,Same,47
1343,1472,129,0.918309298,1.110128852,1117,1044,1,1,'01_12_01.c3d',15,VV,B,H,1,Same,73
1005,1049,44,1.024230961,1.110743308,736,727,253,237,'01_12_02.c3d',15,VV,B,H,2,Same,9
1071,1127,56,0.80043558,0.987293093,807,954,255,256,'01_12_03.c3d',15,VV,B,H,3,Same,147
876,907,31,1.013825707,1.059589772,612,553,87,63,'01_12_04.c3d',15,VV,B,H,4,Same,59
1109,1126,17,0.899301343,1.054007569,833,748,241,1,'01_12_05.c3d',15,VV,B,H,5,Same,85
871,1077,206,0.941180816,1.434414275,758,662,1,284,'01_12_01.c3d',16,VV,B,H,1,Same,96
946,985,39,1.20748514,1.441668706,677,605,262,1,'01_12_02.c3d',16,VV,B,H,2,Same,72
1216,1249,33,0.793547091,1.03298169,1020,1013,325,300,'01_12_03.c3d',16,VV,B,H,3,Same,7
1191,1418,227,0.690031985,0.812746172,990,868,238,1,'01_12_04.c3d',16,VV,B,H,4,Same,122
1083,1229,146,0.774761503,0.956330854,816,754,1,1,'01_12_05.c3d',16,VV,B,H,5,Same,62
610,670,60,1.777748287,1.612053394,387,486,230,234,'01_12_01.c3d',17,VV,B,H,1,Same,99
571,634,63,2.157509311,1.930227634,482,539,246,251,'01_12_02.c3d',17,VV,B,H,2,Same,57
758,941,183,1.556431108,1.40926598,526,508,279,276,'01_12_03.c3d',17,VV,B,H,3,Same,18
681,743,62,1.743766313,1.711070721,535,589,273,1,'01_12_04.c3d',17,VV,B,H,4,Same,54
531,916,385,2.32781587,1.951160438,484,493,246,234,'01_12_05.c3d',17,VV,B,H,5,Same,9
1172,1179,7,0.867541671,1.003100203,854,947,1,1,'01_12_01.c3d',18,VV,B,H,1,Same,93
917,1902,985,1.014781781,1.275438268,726,727,1,1,'01_12_02.c3d',18,VV,B,H,2,Same,1
1072,1161,89,0.910809597,1.016483294,718,768,295,317,'01_12_03.c3d',18,VV,B,H,3,Same,50
643,1418,775,0.895704894,0.872291965,532,581,1,1,'01_12_04.c3d',18,VV,B,H,4,Same,49
858,2383,1525,1.098208477,1.049622784,699,730,1,260,'01_12_05.c3d',18,VV,B,H,5,Same,31
1394,1589,195,0.693114873,0.783322857,951,991,1,1,'01_12_01.c3d',19,VV,B,H,1,Same,40
1026,1176,150,0.816683388,0.996189295,881,796,1,241,'01_12_02.c3d',19,VV,B,H,2,Same,85
928,943,15,1.035945101,1.190811859,796,648,1,274,'01_12_03.c3d',19,VV,B,H,3,Same,148
1159,1236,77,0.900079166,0.923075022,846,634,1,283,'01_12_04.c3d',19,VV,B,H,4,Same,212
1004,1289,285,0.892330364,0.821544839,848,707,381,1,'01_12_05.c3d',19,VV,B,H,5,Same,141
988,1073,85,0.93550562,1.055105743,765,797,289,293,'01_12_01.c3d',20,VV,B,H,1,Same,32
1104,1185,81,0.827878704,0.935237732,853,832,333,317,'01_12_02.c3d',20,VV,B,H,2,Same,21
1169,1301,132,0.857212083,1.114418853,971,994,449,426,'01_12_03.c3d',20,VV,B,H,3,Same,23
1134,1172,38,0.7599977,0.935322694,830,805,295,1,'01_12_04.c3d',20,VV,B,H,4,Same,25
995,1053,58,1.134682434,1.078743749,825,808,335,321,'01_12_05.c3d',20,VV,B,H,5,Same,17
1892,1900,8,0.559614117,1.029408754,1115,964,1,374,'01_12_01.c3d',21,VV,B,H,1,Same,151
1099,1131,32,0.842397238,0.904574943,895,918,1,315,'01_12_02.c3d',21,VV,B,H,2,Same,23
1185,1187,2,0.850252131,0.871499304,861,826,1,1,'01_12_03.c3d',21,VV,B,H,3,Same,35
1463,1567,104,0.567287813,0.559627202,824,854,367,1,'01_12_04.c3d',21,VV,B,H,4,Same,30
1431,1470,39,0.640123038,0.65116285,885,1006,419,1,'01_12_05.c3d',21,VV,B,H,5,Same,121
1105,1208,103,0.874020575,1.29367894,856,1050,296,352,'01_12_01.c3d',22,VV,B,H,1,Same,194
1119,1185,66,0.924291262,1.289062317,867,957,295,1,'01_12_02.c3d',22,VV,B,H,2,Same,90
1215,1246,31,0.849300552,1.18509931,950,989,315,1,'01_12_03.c3d',22,VV,B,H,3,Same,39
1384,1444,60,0.759797135,1.182188856,1146,1141,473,473,'01_12_04.c3d',22,VV,B,H,4,Same,5
1448,1977,529,0.607610478,1.042479804,995,1114,1,397,'01_12_05.c3d',22,VV,B,H,5,Same,119
3513,5914,2401,0.472910033,0.513423187,1113,1201,1,273,'01_12_01.c3d',23,VV,B,H,1,Same,88
2102,2268,166,0.380350137,0.464329254,958,1593,289,1,'01_12_02.c3d',23,VV,B,H,2,Same,635
2528,3225,697,0.300617757,0.336525809,1058,1343,259,286,'01_12_03.c3d',23,VV,B,H,3,Same,285
2546,2648,102,0.318098936,0.438636528,1391,1889,1,321,'01_12_04.c3d',23,VV,B,H,4,Same,498
2661,4155,1494,0.365766581,0.460113344,1283,1333,228,261,'01_12_05.c3d',23,VV,B,H,5,Same,50
1070,1375,305,0.958898298,0.7986279,768,758,1,290,'01_12_01.c3d',24,VV,B,H,1,Same,10
1060,1093,33,0.811919331,0.906706619,697,921,1,1,'01_12_02.c3d',24,VV,B,H,2,Same,224
1245,1301,56,0.63127394,0.80345927,755,981,136,1,'01_12_03.c3d',24,VV,B,H,3,Same,226
996,1080,84,0.973087926,0.963998264,800,865,301,286,'01_12_04.c3d',24,VV,B,H,4,Same,65
1195,1245,50,0.632359816,0.788774424,803,839,149,1,'01_12_05.c3d',24,VV,B,H,5,Same,36
1428,1911,483,0.786974844,0.663484173,803,762,322,333,'01_12_01.c3d',25,VV,B,H,1,Same,41
1152,1190,38,0.81941854,0.790179346,642,645,258,1,'01_12_02.c3d',25,VV,B,H,2,Same,3
1028,1041,13,0.908165545,0.808280186,709,653,224,221,'01_12_03.c3d',25,VV,B,H,3,Same,56
1149,1220,71,0.733956747,0.686849456,791,606,242,1,'01_12_04.c3d',25,VV,B,H,4,Same,185
1127,1264,137,0.892624516,0.782637824,749,775,252,228,'01_12_05.c3d',25,VV,B,H,5,Same,26
1138,2885,1747,0.523915379,0.762559278,1182,554,1,1,'01_12_01.c3d',26,VV,B,H,1,Same,628
1433,1692,259,0.397610746,0.495735749,1145,1032,268,282,'01_12_02.c3d',26,VV,B,H,2,Same,113
1119,1203,84,0.710470301,0.753007366,970,786,270,268,'01_12_03.c3d',26,VV,B,H,3,Same,184
1261,1310,49,0.619894625,0.642005275,889,1051,323,1,'01_12_04.c3d',26,VV,B,H,4,Same,162
1929,2183,254,0.406975756,0.442993304,1338,1098,1,325,'01_12_05.c3d',26,VV,B,H,5,Same,240
1921,2049,128,0.715502478,0.901120147,1321,1423,1,1,'01_12_01.c3d',27,VV,B,H,1,Same,102
1205,1334,129,0.966120149,1.181358632,980,950,356,342,'01_12_02.c3d',27,VV,B,H,2,Same,30
1379,1399,20,0.781600883,0.877649288,935,851,1,290,'01_12_03.c3d',27,VV,B,H,3,Same,84
1972,3145,1173,0.616283621,0.802476322,1386,1326,1,1,'01_12_04.c3d',27,VV,B,H,4,Same,60
1361,1839,478,0.685073672,0.937901271,810,1006,1,1,'01_12_05.c3d',27,VV,B,H,5,Same,196
1493,2750,1257,0.848697344,0.92011845,1150,2378,1,479,'01_12_01.c3d',28,VV,B,H,1,Same,1228
1744,2869,1125,0.724709666,0.721797871,1374,2673,517,840,'01_12_02.c3d',28,VV,B,H,2,Same,1299
1120,1305,185,0.837883382,0.990765925,921,991,248,1,'01_12_03.c3d',28,VV,B,H,3,Same,70
1860,3301,1441,0.740534038,0.793805436,1586,1689,242,1,'01_12_04.c3d',28,VV,B,H,4,Same,103
1602,1745,143,0.54027121,0.697678956,1295,944,1,1,'01_12_05.c3d',28,VV,B,H,5,Same,351
999,1091,92,0.708144072,0.93879205,780,754,197,1,'01_12_01.c3d',29,VV,B,H,1,Same,26
1243,1279,36,0.60390687,0.759357338,907,921,1,1,'01_12_02.c3d',29,VV,B,H,2,Same,14
1183,1245,62,0.693245452,0.752725992,861,871,247,227,'01_12_03.c3d',29,VV,B,H,3,Same,10
1012,1042,30,0.940170641,1.123844268,797,727,313,300,'01_12_04.c3d',29,VV,B,H,4,Same,70
1000,1047,47,0.786695601,1.042137875,691,641,1,1,'01_12_05.c3d',29,VV,B,H,5,Same,50
1153,1305,152,0.794074218,0.643593961,908,902,1,1,'01_12_01.c3d',30,VV,B,H,1,Same,6
929,1100,171,0.843700317,0.940480328,790,522,262,264,'01_12_02.c3d',30,VV,B,H,2,Same,268
1234,1254,20,0.627953993,0.608421843,871,958,1,258,'01_12_03.c3d',30,VV,B,H,3,Same,87
1178,1194,16,0.608834395,0.617544376,740,695,1,1,'01_12_04.c3d',30,VV,B,H,4,Same,45
1117,1237,120,0.731228368,0.594883423,843,827,169,1,'01_12_05.c3d',30,VV,B,H,5,Same,16
1091,1092,1,1.310333399,1.213178714,885,845,359,329,'01_12_01.c3d',31,VV,B,H,1,Same,40
1084,1211,127,1.198085794,1.28831733,737,804,372,362,'01_12_02.c3d',31,VV,B,H,2,Same,67
1087,1105,18,1.200390044,1.13039094,759,728,293,286,'01_12_03.c3d',31,VV,B,H,3,Same,31
1033,1039,6,1.250252399,1.34576058,684,663,291,293,'01_12_04.c3d',31,VV,B,H,4,Same,21
1148,1200,52,1.302295705,1.170301274,715,669,351,344,'01_12_05.c3d',31,VV,B,H,5,Same,46
951,955,4,0.978706505,1.136629376,723,761,293,285,'01_12_01.c3d',32,VV,B,H,1,Same,38
929,1053,124,0.989226109,1.198337492,729,764,1,1,'01_12_02.c3d',32,VV,B,H,2,Same,35
1219,1251,32,0.76474633,0.940887885,890,942,297,275,'01_12_03.c3d',32,VV,B,H,3,Same,52
1283,1515,232,0.768348574,0.795328413,867,935,32,290,'01_12_04.c3d',32,VV,B,H,4,Same,68
1163,1345,182,0.843099928,0.762175472,849,873,1,295,'01_12_05.c3d',32,VV,B,H,5,Same,24
1433,1612,179,0.631169742,0.907058334,1110,1119,376,372,'01_12_01.c3d',33,VV,B,H,1,Same,9
1604,1654,50,0.674841505,0.807923206,1291,1312,437,428,'01_12_02.c3d',33,VV,B,H,2,Same,21
1335,1349,14,0.831723489,0.957153666,1030,1023,408,397,'01_12_03.c3d',33,VV,B,H,3,Same,7
1224,1232,8,0.922086577,1.011901553,1006,1122,1,1,'01_12_04.c3d',33,VV,B,H,4,Same,116
1375,1514,139,0.795324962,0.681287694,1027,1211,338,344,'01_12_05.c3d',33,VV,B,H,5,Same,184
962,1340,378,0.992284115,1.15140169,702,701,333,318,'01_12_01.c3d',34,VV,B,H,1,Same,1
976,2053,1077,0.905615128,1.028426665,877,851,366,269,'01_12_02.c3d',34,VV,B,H,2,Same,26
1541,2018,477,0.638668214,0.635342334,1092,1106,325,305,'01_12_03.c3d',34,VV,B,H,3,Same,14
1288,1333,45,0.651458806,0.764872202,883,918,314,305,'01_12_04.c3d',34,VV,B,H,4,Same,35
973,996,23,0.862579081,0.944594884,697,655,261,260,'01_12_05.c3d',34,VV,B,H,5,Same,42
1143,1273,130,0.801912639,0.873710632,919,727,1,1,'01_12_01.c3d',35,VV,B,H,1,Same,192
955,1089,134,1.06793979,1.014301249,719,660,204,1,'01_12_02.c3d',35,VV,B,H,2,Same,59
1392,1505,113,0.887811412,0.801460199,615,645,1,1,'01_12_03.c3d',35,VV,B,H,3,Same,30
1071,1401,330,1.131299015,1.084105532,715,737,1,1,'01_12_04.c3d',35,VV,B,H,4,Same,22
1171,1189,18,0.923763308,0.897706021,738,805,232,227,'01_12_05.c3d',35,VV,B,H,5,Same,67
944,2041,1097,0.475137374,0.822656212,834,1133,348,358,'01_13_01.c3d',1,VV,L,E,1,Same,299
819,1239,420,0.658385369,0.962182231,675,682,105,251,'01_13_02.c3d',1,VV,L,E,2,Same,7
817,1227,410,0.583394557,0.795447158,629,573,1,143,'01_13_03.c3d',1,VV,L,E,3,Same,56
710,1125,415,0.573570512,0.897359566,610,805,1,68,'01_13_04.c3d',1,VV,L,E,4,Same,195
723,973,250,0.547740835,1.18265506,563,712,1,98,'01_13_05.c3d',1,VV,L,E,5,Same,149
869,2153,1284,0.537053938,1.096829109,751,1091,374,1,'01_13_01.c3d',2,VV,L,E,1,Same,340
740,1552,812,0.594369706,0.910637493,619,909,1,1,'01_13_02.c3d',2,VV,L,E,2,Same,290
794,1245,451,0.609952753,1.055452807,711,1111,258,1,'01_13_03.c3d',2,VV,L,E,3,Same,400
798,1966,1168,0.657559277,0.808776646,636,1131,319,1,'01_13_04.c3d',2,VV,L,E,4,Same,495
787,1342,555,0.416097412,0.830973228,518,1081,31,150,'01_13_05.c3d',2,VV,L,E,5,Same,563
777,1407,630,0.747961791,1.675466391,517,761,1,1,'01_13_01.c3d',3,VV,L,E,1,Same,244
570,651,81,0.776831566,1.754276666,425,573,1,60,'01_13_02.c3d',3,VV,L,E,2,Same,148
644,844,200,0.686155994,1.335261512,487,695,191,1,'01_13_03.c3d',3,VV,L,E,3,Same,208
731,923,192,0.622647722,1.34330371,552,771,1,289,'01_13_04.c3d',3,VV,L,E,4,Same,219
739,1045,306,0.698796461,1.116269724,521,589,255,1,'01_13_05.c3d',3,VV,L,E,5,Same,68
775,1452,677,0.607613704,1.12563863,690,766,1,1,'01_13_01.c3d',4,VV,L,E,1,Same,76
644,1333,689,0.782991213,1.027228657,616,764,1,302,'01_13_02.c3d',4,VV,L,E,2,Same,148
749,1346,597,0.58162611,1.403443391,709,706,1,345,'01_13_03.c3d',4,VV,L,E,3,Same,3
680,1098,418,0.613969773,0.936262043,496,796,1,281,'01_13_04.c3d',4,VV,L,E,4,Same,300
769,1077,308,0.600087008,0.917186459,702,811,1,1,'01_13_05.c3d',4,VV,L,E,5,Same,109
551,958,407,1.04859782,1.967678954,488,546,259,274,'01_13_01.c3d',5,VV,L,E,1,Same,58
541,710,169,1.064989077,1.98971595,462,588,275,276,'01_13_02.c3d',5,VV,L,E,2,Same,126
683,752,69,0.908439367,1.771146113,370,528,231,227,'01_13_03.c3d',5,VV,L,E,3,Same,158
609,694,85,1.111076617,2.245681023,443,595,327,316,'01_13_04.c3d',5,VV,L,E,4,Same,152
539,894,355,0.71610294,1.415762617,453,586,161,191,'01_13_05.c3d',5,VV,L,E,5,Same,133
784,1203,419,0.579104942,0.957281889,580,1160,1,1,'01_13_01.c3d',6,VV,L,E,1,Same,580
766,2091,1325,0.570149773,1.189871361,548,1143,246,269,'01_13_02.c3d',6,VV,L,E,2,Same,595
897,2622,1725,0.703736695,0.879523536,755,832,1,45,'01_13_03.c3d',6,VV,L,E,3,Same,77
800,1283,483,0.489944936,0.920190449,722,987,154,1,'01_13_04.c3d',6,VV,L,E,4,Same,265
882,1187,305,0.401059348,0.771713518,738,836,1,268,'01_13_05.c3d',6,VV,L,E,5,Same,98
823,1962,1139,0.488484293,0.646146586,682,665,344,1,'01_13_01.c3d',7,VV,L,E,1,Same,17
694,943,249,0.589819259,0.869033464,547,813,1,278,'01_13_02.c3d',7,VV,L,E,2,Same,266
782,1047,265,0.575401805,0.848558652,577,826,1,1,'01_13_03.c3d',7,VV,L,E,3,Same,249
652,925,273,0.646308582,0.861085551,555,656,1,1,'01_13_04.c3d',7,VV,L,E,4,Same,101
636,957,321,0.601242468,0.837968553,576,645,220,45,'01_13_05.c3d',7,VV,L,E,5,Same,69
749,1394,645,0.481394798,0.873896593,473,716,1,303,'01_13_01.c3d',8,VV,L,E,1,Same,243
804,1291,487,0.335581224,0.609728102,350,752,1,1,'01_13_02.c3d',8,VV,L,E,2,Same,402
1270,1911,641,0.362780052,0.48519513,722,1019,1,1,'01_13_03.c3d',8,VV,L,E,3,Same,297
635,1168,533,0.524965308,0.789824569,422,708,51,106,'01_13_04.c3d',8,VV,L,E,4,Same,286
891,1054,163,0.408880747,0.875356765,335,655,1,62,'01_13_05.c3d',8,VV,L,E,5,Same,320
1147,2008,861,0.226706376,1.013386124,663,496,1,359,'01_13_01.c3d',9,VV,L,E,1,Same,167
1177,1601,424,0.475880714,1.365643432,632,551,1,302,'01_13_02.c3d',9,VV,L,E,2,Same,81
921,975,54,0.514503524,1.115064616,612,606,1,273,'01_13_03.c3d',9,VV,L,E,3,Same,6
662,1852,1190,0.689241116,1.098553467,578,572,251,249,'01_13_04.c3d',9,VV,L,E,4,Same,6
714,1039,325,0.575951602,1.054616548,523,620,1,255,'01_13_05.c3d',9,VV,L,E,5,Same,97
601,645,44,0.833174859,3.01399958,471,645,91,274,'01_13_01.c3d',10,VV,L,E,1,Same,174
899,947,48,0.481864539,1.754725558,707,646,291,322,'01_13_02.c3d',10,VV,L,E,2,Same,61
824,861,37,0.448375553,1.574830125,740,682,1,263,'01_13_03.c3d',10,VV,L,E,3,Same,58
396,716,320,0.733572104,1.215878661,307,613,1,1,'01_13_04.c3d',10,VV,L,E,4,Same,306
762,901,139,0.707959961,1.566482078,486,584,195,202,'01_13_05.c3d',10,VV,L,E,5,Same,98
1006,2128,1122,0.458436999,0.887378249,822,1009,1,40,'01_13_01.c3d',11,VV,L,E,1,Same,187
782,1744,962,0.604163727,0.937821433,673,755,1,1,'01_13_02.c3d',11,VV,L,E,2,Same,82
886,1473,587,0.446898897,0.74976761,768,962,1,1,'01_13_03.c3d',11,VV,L,E,3,Same,194
1293,1890,597,0.278698141,0.531158544,1137,1263,1,358,'01_13_04.c3d',11,VV,L,E,4,Same,126
912,1737,825,0.547901589,0.648757836,852,988,1,336,'01_13_05.c3d',11,VV,L,E,5,Same,136
1333,1419,86,0.735070274,1.366400523,469,654,286,1,'01_13_01.c3d',12,VV,L,E,1,Same,185
852,1192,340,0.644078956,1.238303002,447,742,1,279,'01_13_02.c3d',12,VV,L,E,2,Same,295
709,1063,354,0.5817492,1.045035685,443,733,1,236,'01_13_03.c3d',12,VV,L,E,3,Same,290
724,1458,734,0.611482053,0.660394409,498,724,269,1,'01_13_04.c3d',12,VV,L,E,4,Same,226
623,1337,714,0.719705615,1.620734981,388,585,252,1,'01_13_05.c3d',12,VV,L,E,5,Same,197
849,1115,266,0.766234824,1.104736023,762,825,371,384,'01_13_01.c3d',13,VV,L,E,1,Same,63
767,1724,957,0.625212667,1.264466096,644,750,82,1,'01_13_02.c3d',13,VV,L,E,2,Same,106
842,1482,640,0.717683403,1.058624534,718,888,1,1,'01_13_03.c3d',13,VV,L,E,3,Same,170
722,996,274,0.633982546,1.151077068,599,623,117,1,'01_13_04.c3d',13,VV,L,E,4,Same,24
798,1008,210,0.69744946,1.2290105,639,790,361,1,'01_13_05.c3d',13,VV,L,E,5,Same,151
536,621,85,0.904304341,1.783635866,337,429,1,207,'01_13_01.c3d',14,VV,L,E,1,Same,92
631,1144,513,0.755589773,2.271168958,395,525,1,245,'01_13_02.c3d',14,VV,L,E,2,Same,130
513,711,198,1.017067336,1.726536092,435,522,1,1,'01_13_03.c3d',14,VV,L,E,3,Same,87
590,936,346,0.789275705,1.750374903,564,614,1,292,'01_13_04.c3d',14,VV,L,E,4,Same,50
638,887,249,0.716939057,1.498419123,518,584,127,257,'01_13_05.c3d',14,VV,L,E,5,Same,66
854,978,124,0.738886569,2.021178829,723,851,1,1,'01_13_01.c3d',15,VV,L,E,1,Same,128
742,861,119,0.597807233,1.475503031,667,752,261,1,'01_13_02.c3d',15,VV,L,E,2,Same,85
742,1024,282,0.643798955,1.294124959,673,717,1,1,'01_13_03.c3d',15,VV,L,E,3,Same,44
703,975,272,0.623046672,1.305874048,642,721,245,1,'01_13_04.c3d',15,VV,L,E,4,Same,79
617,856,239,0.698683345,1.178762022,390,613,40,69,'01_13_05.c3d',15,VV,L,E,5,Same,223
852,2139,1287,0.635808662,1.832407229,679,711,324,358,'01_13_01.c3d',16,VV,L,E,1,Same,32
652,1699,1047,0.57896689,1.164368648,595,704,119,183,'01_13_02.c3d',16,VV,L,E,2,Same,109
873,1035,162,0.61010146,1.269783839,552,707,275,163,'01_13_03.c3d',16,VV,L,E,3,Same,155
859,955,96,0.529742377,1.396458804,725,627,1,246,'01_13_04.c3d',16,VV,L,E,4,Same,98
1239,1776,537,0.319773011,0.905536478,694,749,199,242,'01_13_05.c3d',16,VV,L,E,5,Same,55
1653,1927,274,0.343344725,0.689845907,1443,1685,1,740,'01_13_01.c3d',17,VV,L,E,1,Same,242
568,1093,525,0.90436883,1.650620376,418,448,246,262,'01_13_02.c3d',17,VV,L,E,2,Same,30
602,769,167,0.774721077,1.638070772,509,556,264,268,'01_13_03.c3d',17,VV,L,E,3,Same,47
544,783,239,0.793760177,1.529512745,420,573,256,256,'01_13_04.c3d',17,VV,L,E,4,Same,153
609,613,4,1.225275422,2.374310764,397,484,256,271,'01_13_05.c3d',17,VV,L,E,5,Same,87
1053,1559,506,0.739193651,1.408588557,521,748,1,1,'01_13_01.c3d',18,VV,L,E,1,Same,227
607,1865,1258,0.700029652,1.908997386,666,657,1,1,'01_13_02.c3d',18,VV,L,E,2,Same,9
667,1304,637,0.799714422,1.533240473,584,763,263,1,'01_13_03.c3d',18,VV,L,E,3,Same,179
1084,1223,139,2.426621331,3.075682418,1,1,1,1,'01_13_04.c3d',18,VV,L,E,4,Same,0
752,979,227,0.704557037,1.660194257,484,623,1,1,'01_13_05.c3d',18,VV,L,E,5,Same,139
807,950,143,0.525618054,1.229436787,631,636,1,1,'01_13_01.c3d',19,VV,L,E,1,Same,5
777,868,91,0.55892533,1.227171825,553,706,1,289,'01_13_02.c3d',19,VV,L,E,2,Same,153
684,754,70,0.629741398,1.470892955,467,583,213,231,'01_13_03.c3d',19,VV,L,E,3,Same,116
665,863,198,0.723590333,1.371558413,560,609,274,275,'01_13_04.c3d',19,VV,L,E,4,Same,49
770,966,196,0.548739833,1.198557747,621,616,44,264,'01_13_05.c3d',19,VV,L,E,5,Same,5
707,1332,625,0.711980592,1.130275161,592,756,1,275,'01_13_01.c3d',20,VV,L,E,1,Same,164
785,1573,788,0.687070606,1.301928443,668,740,350,364,'01_13_02.c3d',20,VV,L,E,2,Same,72
799,992,193,0.595328474,1.155438406,601,623,1,245,'01_13_03.c3d',20,VV,L,E,3,Same,22
745,924,179,0.603161977,1.124163093,534,575,1,1,'01_13_04.c3d',20,VV,L,E,4,Same,41
815,1144,329,0.645086953,1.07420369,620,613,288,250,'01_13_05.c3d',20,VV,L,E,5,Same,7
673,1306,633,0.763526593,1.013473534,609,731,1,1,'01_13_01.c3d',21,VV,L,E,1,Same,122
707,1668,961,0.718591401,1.052525841,648,781,303,312,'01_13_02.c3d',21,VV,L,E,2,Same,133
816,1885,1069,0.750300743,0.832004044,739,832,1,442,'01_13_03.c3d',21,VV,L,E,3,Same,93
874,1397,523,0.59197523,0.70008013,660,1173,1,403,'01_13_04.c3d',21,VV,L,E,4,Same,513
863,1521,658,0.625815225,0.929469888,673,780,357,365,'01_13_05.c3d',21,VV,L,E,5,Same,107
897,1903,1006,0.650540088,0.647747977,822,1205,1,322,'01_13_01.c3d',22,VV,L,E,1,Same,383
794,1896,1102,0.81228309,1.382079665,677,1267,345,1,'01_13_02.c3d',22,VV,L,E,2,Same,590
830,1238,408,0.665115282,1.205319543,665,838,317,364,'01_13_03.c3d',22,VV,L,E,3,Same,173
777,1130,353,0.631734539,1.348227617,659,919,275,333,'01_13_04.c3d',22,VV,L,E,4,Same,260
807,1251,444,0.604890882,1.137356748,683,998,263,372,'01_13_05.c3d',22,VV,L,E,5,Same,315
1132,1887,755,0.371657935,0.652318532,955,1265,1,342,'01_13_01.c3d',23,VV,L,E,1,Same,310
959,1437,478,0.367550243,0.772781285,693,1220,60,261,'01_13_02.c3d',23,VV,L,E,2,Same,527
1096,2334,1238,0.308481753,0.428334341,879,1812,288,1,'01_13_03.c3d',23,VV,L,E,3,Same,933
1474,2372,898,0.259342108,0.501241498,745,1942,1,328,'01_13_04.c3d',23,VV,L,E,4,Same,1197
1391,2055,664,0.251870836,0.589512091,1131,1257,270,317,'01_13_05.c3d',23,VV,L,E,5,Same,126
670,1043,373,0.659561766,1.233912487,607,673,251,1,'01_13_01.c3d',24,VV,L,E,1,Same,66
715,924,209,0.750593248,1.274403315,604,722,294,321,'01_13_02.c3d',24,VV,L,E,2,Same,118
735,935,200,0.520650229,0.999344573,445,659,1,145,'01_13_03.c3d',24,VV,L,E,3,Same,214
703,927,224,0.644723092,1.11619252,566,673,228,234,'01_13_04.c3d',24,VV,L,E,4,Same,107
708,1325,617,0.530599814,0.843617043,533,739,25,98,'01_13_05.c3d',24,VV,L,E,5,Same,206
733,1719,986,0.629961847,1.009888274,560,629,226,262,'01_13_01.c3d',25,VV,L,E,1,Same,69
725,947,222,0.580441259,0.988767748,589,624,258,258,'01_13_02.c3d',25,VV,L,E,2,Same,35
730,996,266,0.515185777,1.028124974,624,596,239,246,'01_13_03.c3d',25,VV,L,E,3,Same,28
786,1168,382,0.478851682,0.819751015,628,657,1,257,'01_13_04.c3d',25,VV,L,E,4,Same,29
1028,1305,277,0.361720784,0.805519905,598,637,239,267,'01_13_05.c3d',25,VV,L,E,5,Same,39
821,1544,723,0.496505756,0.865104497,781,619,260,261,'01_13_01.c3d',26,VV,L,E,1,Same,162
972,1650,678,0.354610242,0.953914584,623,607,1,1,'01_13_02.c3d',26,VV,L,E,2,Same,16
1075,1165,90,0.276886154,0.746289901,486,910,162,248,'01_13_03.c3d',26,VV,L,E,3,Same,424
1069,1136,67,0.346986951,0.76528434,689,947,1,358,'01_13_04.c3d',26,VV,L,E,4,Same,258
1309,1950,641,0.242996005,0.870581208,883,662,10,262,'01_13_05.c3d',26,VV,L,E,5,Same,221
1140,1360,220,0.570589413,1.119751727,890,1042,587,544,'01_13_01.c3d',27,VV,L,E,1,Same,152
944,1287,343,0.769994509,1.110876134,831,951,511,1,'01_13_02.c3d',27,VV,L,E,2,Same,120
1255,1498,243,0.660517863,0.972463621,911,1010,540,1,'01_13_03.c3d',27,VV,L,E,3,Same,99
2502,2575,73,0.449142585,0.760692789,1001,1346,657,412,'01_13_04.c3d',27,VV,L,E,4,Same,345
1148,1432,284,0.501895149,1.140718543,833,902,393,403,'01_13_05.c3d',27,VV,L,E,5,Same,69
1537,3088,1551,0.378353351,0.663691611,1142,2490,1,385,'01_13_01.c3d',28,VV,L,E,1,Same,1348
871,1303,432,0.589409714,0.989693263,703,946,1,306,'01_13_02.c3d',28,VV,L,E,2,Same,243
1355,1864,509,0.3708414,0.639724563,1109,1587,1,1,'01_13_03.c3d',28,VV,L,E,3,Same,478
980,1467,487,0.516897144,0.813567838,768,1075,1,345,'01_13_04.c3d',28,VV,L,E,4,Same,307
889,1620,731,0.622625905,0.892263833,678,1440,312,1,'01_13_05.c3d',28,VV,L,E,5,Same,762
714,1146,432,0.547515233,1.414936579,665,635,75,70,'01_13_01.c3d',29,VV,L,E,1,Same,30
825,995,170,0.472490857,1.092238138,832,714,1,289,'01_13_02.c3d',29,VV,L,E,2,Same,118
672,1316,644,0.634682893,0.94783145,634,690,1,255,'01_13_03.c3d',29,VV,L,E,3,Same,56
754,1051,297,0.55055864,1.030514754,581,815,295,290,'01_13_04.c3d',29,VV,L,E,4,Same,234
711,1852,1141,0.462907663,1.023131804,494,732,37,268,'01_13_05.c3d',29,VV,L,E,5,Same,238
727,916,189,0.617897538,1.039890906,621,716,1,1,'01_13_01.c3d',30,VV,L,E,1,Same,95
803,982,179,0.555048373,0.90119819,599,766,1,271,'01_13_02.c3d',30,VV,L,E,2,Same,167
750,1548,798,0.486453367,0.737924222,537,867,219,262,'01_13_03.c3d',30,VV,L,E,3,Same,330
833,1008,175,0.411519518,0.870911022,410,677,1,1,'01_13_04.c3d',30,VV,L,E,4,Same,267
652,1285,633,0.577961476,0.777679091,554,682,114,1,'01_13_05.c3d',30,VV,L,E,5,Same,128
880,1768,888,0.865849003,1.361962759,772,764,430,430,'01_13_01.c3d',31,VV,L,E,1,Same,8
655,968,313,1.129821075,1.514405359,566,603,295,309,'01_13_02.c3d',31,VV,L,E,2,Same,37
1118,1311,193,0.988561285,1.652902249,1023,1054,718,423,'01_13_03.c3d',31,VV,L,E,3,Same,31
743,876,133,0.824600168,1.606111082,629,651,290,279,'01_13_04.c3d',31,VV,L,E,4,Same,22
770,884,114,0.764650679,1.620200837,631,657,294,305,'01_13_05.c3d',31,VV,L,E,5,Same,26
766,879,113,0.655904105,1.298458255,607,654,311,283,'01_13_01.c3d',32,VV,L,E,1,Same,47
782,1327,545,0.655122331,1.261673736,696,839,1,308,'01_13_02.c3d',32,VV,L,E,2,Same,143
766,1049,283,0.6830865,1.00337082,682,939,1,334,'01_13_03.c3d',32,VV,L,E,3,Same,257
907,1230,323,0.486794859,1.198253521,745,914,1,363,'01_13_04.c3d',32,VV,L,E,4,Same,169
851,1097,246,0.589036,1.023219544,724,860,1,1,'01_13_05.c3d',32,VV,L,E,5,Same,136
921,1592,671,0.688746122,0.782150811,804,1107,1,320,'01_13_01.c3d',33,VV,L,E,1,Same,303
1105,1231,126,0.581597627,0.992009724,863,1066,1,397,'01_13_02.c3d',33,VV,L,E,2,Same,203
1079,1516,437,0.67912534,0.806934164,945,1103,549,543,'01_13_03.c3d',33,VV,L,E,3,Same,158
889,1062,173,0.594282995,1.034995509,708,791,1,291,'01_13_04.c3d',33,VV,L,E,4,Same,83
943,1171,228,0.550928091,0.977343074,708,838,331,1,'01_13_05.c3d',33,VV,L,E,5,Same,130
840,880,40,0.891885463,1.763712975,793,807,1,471,'01_13_01.c3d',34,VV,L,E,1,Same,14
811,916,105,0.64982013,1.680825555,712,748,1,422,'01_13_02.c3d',34,VV,L,E,2,Same,36
651,808,157,0.644773576,1.448909063,588,665,302,1,'01_13_03.c3d',34,VV,L,E,3,Same,77
528,866,338,0.857099116,1.193915758,338,496,1,212,'01_13_04.c3d',34,VV,L,E,4,Same,158
734,887,153,0.560860914,1.035960589,544,593,276,262,'01_13_05.c3d',34,VV,L,E,5,Same,49
572,865,293,0.82099926,1.157174866,432,726,178,193,'01_13_01.c3d',35,VV,L,E,1,Same,294
651,920,269,0.663698893,1.068791291,419,544,1,121,'01_13_02.c3d',35,VV,L,E,2,Same,125
693,1414,721,0.660831532,1.170682464,648,604,214,1,'01_13_03.c3d',35,VV,L,E,3,Same,44
835,1065,230,0.610359182,0.99049062,626,701,309,1,'01_13_04.c3d',35,VV,L,E,4,Same,75
706,1095,389,0.675122184,1.268145122,500,671,198,260,'01_13_05.c3d',35,VV,L,E,5,Same,171
970,1361,391,0.460261646,0.746833057,738,977,1,1,'01_14_01.c3d',1,VV,L,M,1,Same,239
762,1075,313,0.477467544,0.971793835,599,842,38,155,'01_14_02.c3d',1,VV,L,M,2,Same,243
828,1217,389,0.603351603,0.902973518,677,840,269,1,'01_14_03.c3d',1,VV,L,M,3,Same,163
797,1378,581,0.566151178,0.730500649,644,809,249,1,'01_14_04.c3d',1,VV,L,M,4,Same,165
558,1102,544,0.765104641,1.062730402,493,699,78,86,'01_14_05.c3d',1,VV,L,M,5,Same,206
915,1617,702,0.569578012,0.718764539,877,1271,430,1,'01_14_01.c3d',2,VV,L,M,1,Same,394
909,1815,906,0.454637667,0.788656519,609,1425,1,1,'01_14_02.c3d',2,VV,L,M,2,Same,816
871,1620,749,0.541892429,0.826493568,792,1204,1,1,'01_14_03.c3d',2,VV,L,M,3,Same,412
988,1388,400,0.374508749,0.786798554,809,889,245,43,'01_14_04.c3d',2,VV,L,M,4,Same,80
827,1952,1125,0.47764041,0.844232378,738,1249,1,1,'01_14_05.c3d',2,VV,L,M,5,Same,511
1627,1681,54,0.333863116,0.819886197,791,1361,1,632,'01_14_01.c3d',3,VV,L,M,1,Same,570
752,970,218,0.76087309,1.37621907,662,880,1,1,'01_14_02.c3d',3,VV,L,M,2,Same,218
642,1111,469,0.712785156,1.119545569,573,730,236,1,'01_14_03.c3d',3,VV,L,M,3,Same,157
676,928,252,0.639824178,1.111987166,575,586,1,1,'01_14_04.c3d',3,VV,L,M,4,Same,11
631,914,283,0.659449145,1.041143229,444,606,137,1,'01_14_05.c3d',3,VV,L,M,5,Same,162
658,928,270,0.635016273,1.148149045,622,670,277,1,'01_14_01.c3d',4,VV,L,M,1,Same,48
752,969,217,0.591840162,0.95738515,594,656,1,1,'01_14_02.c3d',4,VV,L,M,2,Same,62
695,809,114,0.572263116,1.297964701,472,632,1,267,'01_14_03.c3d',4,VV,L,M,3,Same,160
717,1095,378,0.542403788,0.850803173,606,731,1,1,'01_14_04.c3d',4,VV,L,M,4,Same,125
765,1129,364,0.560168558,0.941888354,693,744,259,291,'01_14_05.c3d',4,VV,L,M,5,Same,51
828,1224,396,0.864974183,1.884265404,571,588,1,1,'01_14_01.c3d',5,VV,L,M,1,Same,17
562,776,214,1.109384995,1.830986316,411,587,1,1,'01_14_02.c3d',5,VV,L,M,2,Same,176
491,705,214,1.050277379,1.672102794,422,458,1,1,'01_14_03.c3d',5,VV,L,M,3,Same,36
510,686,176,0.869803081,1.767731412,322,497,1,206,'01_14_04.c3d',5,VV,L,M,4,Same,175
574,673,99,0.832457346,1.878140392,381,580,286,285,'01_14_05.c3d',5,VV,L,M,5,Same,199
814,1665,851,0.525951785,1.121274464,659,1429,1,811,'01_14_01.c3d',6,VV,L,M,1,Same,770
766,1179,413,0.577610212,0.785538675,658,1066,1,1,'01_14_02.c3d',6,VV,L,M,2,Same,408
759,1179,420,0.53573846,0.778514378,619,749,1,1,'01_14_03.c3d',6,VV,L,M,3,Same,130
821,1104,283,0.492347841,0.831344166,580,901,1,1,'01_14_04.c3d',6,VV,L,M,4,Same,321
826,1131,305,0.540643505,0.853428533,724,856,1,317,'01_14_05.c3d',6,VV,L,M,5,Same,132
772,1238,466,0.45131976,0.686299855,520,798,251,175,'01_14_01.c3d',7,VV,L,M,1,Same,278
723,903,180,0.496222303,0.776977202,373,586,1,1,'01_14_02.c3d',7,VV,L,M,2,Same,213
676,830,154,0.483137932,0.950185491,521,671,1,224,'01_14_03.c3d',7,VV,L,M,3,Same,150
565,924,359,0.553757917,0.735193398,384,602,1,1,'01_14_04.c3d',7,VV,L,M,4,Same,218
772,1023,251,0.471703737,0.718294631,553,826,233,1,'01_14_05.c3d',7,VV,L,M,5,Same,273
939,2022,1083,0.424661466,0.704176065,841,837,1,278,'01_14_01.c3d',8,VV,L,M,1,Same,4
916,1657,741,0.471964554,0.974531669,785,734,1,338,'01_14_02.c3d',8,VV,L,M,2,Same,51
924,1208,284,0.530548375,0.913090635,706,737,1,319,'01_14_03.c3d',8,VV,L,M,3,Same,31
1172,1455,283,0.332420418,0.598703457,816,1072,248,281,'01_14_04.c3d',8,VV,L,M,4,Same,256
1030,1616,586,0.337999244,0.623786945,661,1283,1,1,'01_14_05.c3d',8,VV,L,M,5,Same,622
1404,2314,910,0.336021394,0.704574151,941,1283,8,1,'01_14_01.c3d',9,VV,L,M,1,Same,342
953,1388,435,0.412605376,1.061408141,729,555,1,270,'01_14_02.c3d',9,VV,L,M,2,Same,174
1273,2074,801,0.699393242,1.081323538,635,555,238,231,'01_14_03.c3d',9,VV,L,M,3,Same,80
1342,1729,387,0.655080372,0.751576616,621,597,251,246,'01_14_04.c3d',9,VV,L,M,4,Same,24
1527,1609,82,0.466348607,0.627653263,746,787,264,244,'01_14_05.c3d',9,VV,L,M,5,Same,41
879,893,14,0.452022606,1.45182683,346,618,205,264,'01_14_01.c3d',10,VV,L,M,1,Same,272
771,800,29,0.535542821,1.637262406,372,654,1,224,'01_14_02.c3d',10,VV,L,M,2,Same,282
657,758,101,0.512339457,1.661783891,438,670,1,74,'01_14_03.c3d',10,VV,L,M,3,Same,232
798,853,55,0.475160241,1.539775086,462,756,1,282,'01_14_04.c3d',10,VV,L,M,4,Same,294
751,812,61,0.540302417,1.600711952,489,551,198,222,'01_14_05.c3d',10,VV,L,M,5,Same,62
1036,1277,241,0.431537541,0.730366476,884,1102,404,1,'01_14_01.c3d',11,VV,L,M,1,Same,218
1230,1671,441,0.388631922,0.584541875,967,1196,125,1,'01_14_02.c3d',11,VV,L,M,2,Same,229
1233,2929,1696,0.28158478,0.640048785,857,1254,1,358,'01_14_03.c3d',11,VV,L,M,3,Same,397
1041,1998,957,0.432149151,0.571970327,918,1077,1,1,'01_14_04.c3d',11,VV,L,M,4,Same,159
1335,1964,629,0.306993292,0.450351298,1077,1157,1,1,'01_14_05.c3d',11,VV,L,M,5,Same,80
689,1540,851,0.64117823,1.008976176,616,746,1,278,'01_14_01.c3d',12,VV,L,M,1,Same,130
953,1178,225,0.471263229,0.874293281,715,870,1,369,'01_14_02.c3d',12,VV,L,M,2,Same,155
857,1101,244,0.501356436,0.891947103,563,809,335,1,'01_14_03.c3d',12,VV,L,M,3,Same,246
648,827,179,0.620155893,1.031053901,382,620,1,1,'01_14_04.c3d',12,VV,L,M,4,Same,238
681,1044,363,0.606673743,0.931198717,587,652,201,1,'01_14_05.c3d',12,VV,L,M,5,Same,65
956,1063,107,0.52881177,1.073569599,707,854,77,1,'01_14_01.c3d',13,VV,L,M,1,Same,147
744,1023,279,0.592705817,1.057389109,561,646,245,1,'01_14_02.c3d',13,VV,L,M,2,Same,85
694,950,256,0.666520198,1.084509761,561,716,1,1,'01_14_03.c3d',13,VV,L,M,3,Same,155
616,998,382,0.730769134,1.065425718,497,734,156,237,'01_14_04.c3d',13,VV,L,M,4,Same,237
1123,1377,254,0.597563136,0.988523445,942,1131,603,347,'01_14_05.c3d',13,VV,L,M,5,Same,189
628,829,201,0.772861713,1.463690164,537,657,1,1,'01_14_01.c3d',14,VV,L,M,1,Same,120
687,2208,1521,1.058629592,1.71053004,344,485,1,130,'01_14_02.c3d',14,VV,L,M,2,Same,141
693,1937,1244,0.686819342,1.020714594,576,1745,1,1,'01_14_03.c3d',14,VV,L,M,3,Same,1169
456,642,186,0.906014877,1.761413103,391,429,1,1,'01_14_04.c3d',14,VV,L,M,4,Same,38
549,776,227,0.736594446,1.374497787,443,605,1,1,'01_14_05.c3d',14,VV,L,M,5,Same,162
741,1191,450,0.586192015,1.464942931,423,744,241,242,'01_14_01.c3d',15,VV,L,M,1,Same,321
785,1002,217,0.469554562,1.182855081,549,626,174,157,'01_14_02.c3d',15,VV,L,M,2,Same,77
906,1022,116,0.51354178,1.112247315,455,792,1,1,'01_14_03.c3d',15,VV,L,M,3,Same,337
672,815,143,0.529486042,1.154795697,410,638,1,67,'01_14_04.c3d',15,VV,L,M,4,Same,228
596,822,226,0.604689992,1.052563503,450,486,1,1,'01_14_05.c3d',15,VV,L,M,5,Same,36
790,1307,517,0.634678112,1.597916248,626,645,265,1,'01_14_01.c3d',16,VV,L,M,1,Same,19
855,1535,680,0.523844384,1.400594469,709,648,233,1,'01_14_02.c3d',16,VV,L,M,2,Same,61
760,933,173,0.679737981,1.224552626,616,603,149,205,'01_14_03.c3d',16,VV,L,M,3,Same,13
899,964,65,0.365835255,1.123911347,469,626,1,1,'01_14_04.c3d',16,VV,L,M,4,Same,157
951,1144,193,0.419816264,1.081581482,664,770,1,221,'01_14_05.c3d',16,VV,L,M,5,Same,106
586,634,48,0.907376919,2.042776566,419,521,268,281,'01_14_01.c3d',17,VV,L,M,1,Same,102
577,1136,559,0.785101789,1.303422394,539,590,1,278,'01_14_02.c3d',17,VV,L,M,2,Same,51
484,710,226,1.098164075,1.225605927,160,283,33,29,'01_14_03.c3d',17,VV,L,M,3,Same,123
567,756,189,0.751346005,1.667895974,359,538,246,253,'01_14_04.c3d',17,VV,L,M,4,Same,179
564,757,193,0.777101014,1.853927028,519,553,252,274,'01_14_05.c3d',17,VV,L,M,5,Same,34
976,977,1,0.577415157,1.443535522,701,792,60,1,'01_14_01.c3d',18,VV,L,M,1,Same,91
718,1344,626,0.615335671,1.417061887,696,753,1,1,'01_14_02.c3d',18,VV,L,M,2,Same,57
909,1569,660,0.726793739,1.326397299,474,674,1,1,'01_14_03.c3d',18,VV,L,M,3,Same,200
864,1483,619,0.685230991,1.522931219,617,554,1,302,'01_14_04.c3d',18,VV,L,M,4,Same,63
1186,1340,154,0.83945651,1.576775354,548,674,1,1,'01_14_05.c3d',18,VV,L,M,5,Same,126
817,994,177,0.541939357,1.211809086,716,718,1,1,'01_14_01.c3d',19,VV,L,M,1,Same,2
743,1007,264,0.569541844,1.09097535,548,636,1,1,'01_14_02.c3d',19,VV,L,M,2,Same,88
821,1005,184,0.534952907,0.98863079,642,815,1,287,'01_14_03.c3d',19,VV,L,M,3,Same,173
886,984,98,0.476780274,1.137042126,586,696,256,1,'01_14_04.c3d',19,VV,L,M,4,Same,110
823,992,169,0.53242926,1.138776413,680,694,274,239,'01_14_05.c3d',19,VV,L,M,5,Same,14
815,1008,193,0.637223671,1.157702803,679,747,1,340,'01_14_01.c3d',20,VV,L,M,1,Same,68
753,1315,562,0.6144628,1.059040567,626,604,281,280,'01_14_02.c3d',20,VV,L,M,2,Same,22
830,1085,255,0.560571946,0.962307611,588,725,1,1,'01_14_03.c3d',20,VV,L,M,3,Same,137
838,1195,357,0.519567352,0.862833185,602,639,250,25,'01_14_04.c3d',20,VV,L,M,4,Same,37
974,1029,55,0.548004572,1.195898565,772,705,367,332,'01_14_05.c3d',20,VV,L,M,5,Same,67
771,1473,702,0.557809232,0.801086884,625,801,1,1,'01_14_01.c3d',21,VV,L,M,1,Same,176
1060,1336,276,0.362790398,0.697914816,810,884,1,1,'01_14_02.c3d',21,VV,L,M,2,Same,74
863,1203,340,0.416997373,0.673129886,572,799,47,1,'01_14_03.c3d',21,VV,L,M,3,Same,227
928,1150,222,0.39329164,0.718232838,527,742,237,242,'01_14_04.c3d',21,VV,L,M,4,Same,215
981,1416,435,0.381050376,0.683872459,771,836,246,264,'01_14_05.c3d',21,VV,L,M,5,Same,65
819,1584,765,0.763056661,1.284290948,665,1171,350,366,'01_14_01.c3d',22,VV,L,M,1,Same,506
809,1280,471,0.615695737,1.104733963,689,898,258,1,'01_14_02.c3d',22,VV,L,M,2,Same,209
894,1286,392,0.615528595,1.063530971,661,1002,287,330,'01_14_03.c3d',22,VV,L,M,3,Same,341
759,1240,481,0.634014063,1.141590507,649,1114,1,346,'01_14_04.c3d',22,VV,L,M,4,Same,465
934,1700,766,0.570824854,0.753215421,714,1418,312,359,'01_14_05.c3d',22,VV,L,M,5,Same,704
968,1405,437,0.501467023,0.956816853,877,1050,1,348,'01_14_01.c3d',23,VV,L,M,1,Same,173
1118,1816,698,0.349364384,0.841359244,969,1631,273,304,'01_14_02.c3d',23,VV,L,M,2,Same,662
1040,1948,908,0.323373365,0.594266926,906,1526,222,231,'01_14_03.c3d',23,VV,L,M,3,Same,620
1610,3499,1889,0.321766892,0.616567435,1493,2422,428,467,'01_14_04.c3d',23,VV,L,M,4,Same,929
1523,3292,1769,0.304709459,0.530926068,1430,1752,459,523,'01_14_05.c3d',23,VV,L,M,5,Same,322
733,873,140,0.597049172,1.238351785,510,717,215,244,'01_14_01.c3d',24,VV,L,M,1,Same,207
777,982,205,0.52461514,1.091360454,569,786,226,1,'01_14_02.c3d',24,VV,L,M,2,Same,217
903,1141,238,0.514417992,0.871199374,641,836,114,139,'01_14_03.c3d',24,VV,L,M,3,Same,195
742,1052,310,0.557993939,0.940128902,536,635,207,196,'01_14_04.c3d',24,VV,L,M,4,Same,99
834,1124,290,0.514760323,0.919333204,605,803,1,1,'01_14_05.c3d',24,VV,L,M,5,Same,198
1015,1139,124,0.484313808,0.886080977,590,766,295,323,'01_14_01.c3d',25,VV,L,M,1,Same,176
682,1232,550,0.801957031,1.134802174,523,540,241,255,'01_14_02.c3d',25,VV,L,M,2,Same,17
848,1369,521,0.534827822,0.85419582,789,675,1,271,'01_14_03.c3d',25,VV,L,M,3,Same,114
740,1051,311,0.517531093,0.910583092,651,649,241,256,'01_14_04.c3d',25,VV,L,M,4,Same,2
754,1261,507,0.597452706,0.917424744,621,740,228,261,'01_14_05.c3d',25,VV,L,M,5,Same,119
1155,2074,919,0.291008046,0.748760651,685,699,1,313,'01_14_01.c3d',26,VV,L,M,1,Same,14
1212,2044,832,0.308755965,0.668573625,922,869,473,477,'01_14_02.c3d',26,VV,L,M,2,Same,53
1079,1092,13,0.292968198,0.75280031,701,639,1,1,'01_14_03.c3d',26,VV,L,M,3,Same,62
797,837,40,0.560694576,1.17020517,583,575,1,1,'01_14_04.c3d',26,VV,L,M,4,Same,8
939,977,38,0.405647818,0.785027945,495,748,272,255,'01_14_05.c3d',26,VV,L,M,5,Same,253
933,1276,343,0.556692445,0.970580236,764,988,1,1,'01_14_01.c3d',27,VV,L,M,1,Same,224
1169,1404,235,0.481804643,0.962781053,763,875,1,1,'01_14_02.c3d',27,VV,L,M,2,Same,112
895,1403,508,0.601733711,0.884770576,695,763,27,321,'01_14_03.c3d',27,VV,L,M,3,Same,68
894,1334,440,0.667754409,0.878011047,678,1108,1,1,'01_14_04.c3d',27,VV,L,M,4,Same,430
1029,1340,311,0.610640099,0.916404342,748,972,404,387,'01_14_05.c3d',27,VV,L,M,5,Same,224
953,1975,1022,0.564517007,1.062473004,732,1768,326,222,'01_14_01.c3d',28,VV,L,M,1,Same,1036
1208,1658,450,0.49387041,0.704340675,1086,1261,1,408,'01_14_02.c3d',28,VV,L,M,2,Same,175
938,1491,553,0.536102731,0.811596474,796,1073,312,387,'01_14_03.c3d',28,VV,L,M,3,Same,277
945,1300,355,0.438592698,0.921557725,714,948,245,260,'01_14_04.c3d',28,VV,L,M,4,Same,234
1031,1590,559,0.471576057,0.685583896,733,1060,304,1,'01_14_05.c3d',28,VV,L,M,5,Same,327
1152,1499,347,0.515884674,0.905107803,945,1234,1,1,'01_14_01.c3d',29,VV,L,M,1,Same,289
646,1494,848,0.620780265,1.492673972,613,604,1,250,'01_14_02.c3d',29,VV,L,M,2,Same,9
749,856,107,0.624861825,1.168532325,506,715,1,1,'01_14_03.c3d',29,VV,L,M,3,Same,209
898,1131,233,0.427510194,0.945622486,625,842,273,305,'01_14_04.c3d',29,VV,L,M,4,Same,217
863,1218,355,0.46981915,0.949117015,792,954,149,402,'01_14_05.c3d',29,VV,L,M,5,Same,162
793,869,76,0.48387898,1.054743438,455,633,261,274,'01_14_01.c3d',30,VV,L,M,1,Same,178
800,1116,316,0.492723996,0.775684645,617,768,291,1,'01_14_02.c3d',30,VV,L,M,2,Same,151
1050,1100,50,0.378353525,0.809058642,813,768,296,1,'01_14_03.c3d',30,VV,L,M,3,Same,45
867,1005,138,0.390389553,0.785714793,480,826,1,180,'01_14_04.c3d',30,VV,L,M,4,Same,346
801,1630,829,0.561831227,0.806567989,675,783,320,1,'01_14_05.c3d',30,VV,L,M,5,Same,108
712,1236,524,0.986279792,1.507206038,628,682,342,347,'01_14_01.c3d',31,VV,L,M,1,Same,54
704,1192,488,0.933190967,1.520653739,608,652,311,314,'01_14_02.c3d',31,VV,L,M,2,Same,44
794,1050,256,0.904065188,1.504861126,629,714,371,368,'01_14_03.c3d',31,VV,L,M,3,Same,85
886,922,36,0.637294985,1.401692542,485,638,235,254,'01_14_04.c3d',31,VV,L,M,4,Same,153
738,877,139,0.898944638,1.660902843,476,587,227,235,'01_14_05.c3d',31,VV,L,M,5,Same,111
774,902,128,0.80940958,1.332617003,660,777,305,322,'01_14_01.c3d',32,VV,L,M,1,Same,117
738,1205,467,0.681838216,0.901083774,678,834,1,1,'01_14_02.c3d',32,VV,L,M,2,Same,156
821,1760,939,0.606947767,1.000070154,703,859,341,335,'01_14_03.c3d',32,VV,L,M,3,Same,156
802,1253,451,0.557318403,0.893261406,668,889,1,1,'01_14_04.c3d',32,VV,L,M,4,Same,221
1087,1108,21,0.447286801,1.103362243,693,934,1,378,'01_14_05.c3d',32,VV,L,M,5,Same,241
990,1299,309,0.516046615,0.848330595,754,882,365,348,'01_14_01.c3d',33,VV,L,M,1,Same,128
1085,2166,1081,0.498258532,0.756874772,829,1025,369,376,'01_14_02.c3d',33,VV,L,M,2,Same,196
892,1154,262,0.582541732,1.054620993,776,825,301,313,'01_14_03.c3d',33,VV,L,M,3,Same,49
859,1191,332,0.599248731,0.910561622,621,773,340,1,'01_14_04.c3d',33,VV,L,M,4,Same,152
1268,4519,3251,0.501142884,0.706788109,1034,1914,124,1,'01_14_05.c3d',33,VV,L,M,5,Same,880
809,901,92,0.646488793,1.343603811,680,691,1,351,'01_14_01.c3d',34,VV,L,M,1,Same,11
754,910,156,0.708675645,1.238380236,665,698,366,373,'01_14_02.c3d',34,VV,L,M,2,Same,33
669,906,237,0.596803791,0.989509319,540,607,1,1,'01_14_03.c3d',34,VV,L,M,3,Same,67
884,1028,144,0.431914709,0.843635251,652,703,29,270,'01_14_04.c3d',34,VV,L,M,4,Same,51
732,920,188,0.530643919,0.984231655,561,777,256,250,'01_14_05.c3d',34,VV,L,M,5,Same,216
779,1166,387,0.801119739,0.968877922,598,772,325,1,'01_14_01.c3d',35,VV,L,M,1,Same,174
494,949,455,0.830865828,1.008359452,390,628,1,76,'01_14_02.c3d',35,VV,L,M,2,Same,238
722,924,202,0.644332852,0.974406639,515,608,152,137,'01_14_03.c3d',35,VV,L,M,3,Same,93
367,901,534,0.878171034,0.869163848,267,555,1,1,'01_14_04.c3d',35,VV,L,M,4,Same,288
724,991,267,0.600991257,1.050678487,350,550,9,68,'01_14_05.c3d',35,VV,L,M,5,Same,200
1324,1415,91,0.376658571,0.832912707,1087,1149,1,1,'01_15_01.c3d',1,VV,L,H,1,Same,62
1365,1830,465,0.270834445,0.879603747,830,1013,1,1,'01_15_02.c3d',1,VV,L,H,2,Same,183
850,1524,674,0.480356864,0.611775435,688,894,1,159,'01_15_03.c3d',1,VV,L,H,3,Same,206
546,1074,528,0.63365616,0.852601752,1,1,1,1,'01_15_04.c3d',1,VV,L,H,4,Same,0
721,1034,313,0.449025641,0.807591846,443,692,1,1,'01_15_05.c3d',1,VV,L,H,5,Same,249
1074,2181,1107,0.398560584,0.755012154,918,1331,1,1,'01_15_01.c3d',2,VV,L,H,1,Same,413
993,1558,565,0.427158316,0.851591668,845,1060,1,285,'01_15_02.c3d',2,VV,L,H,2,Same,215
974,1594,620,0.378480017,1.025650452,831,1431,1,1,'01_15_03.c3d',2,VV,L,H,3,Same,600
788,1654,866,0.517249715,0.925565585,749,1027,1,264,'01_15_04.c3d',2,VV,L,H,4,Same,278
937,1824,887,0.366281071,0.916207603,544,1359,190,261,'01_15_05.c3d',2,VV,L,H,5,Same,815
764,869,105,0.642185826,1.550222959,538,797,48,330,'01_15_01.c3d',3,VV,L,H,1,Same,259
898,1038,140,0.604180315,1.291257758,648,874,1,1,'01_15_02.c3d',3,VV,L,H,2,Same,226
727,1048,321,0.519061175,0.96679895,492,772,1,1,'01_15_03.c3d',3,VV,L,H,3,Same,280
729,1064,335,0.609128859,1.279195723,615,844,253,270,'01_15_04.c3d',3,VV,L,H,4,Same,229
786,1922,1136,0.714978062,1.116348758,646,831,329,346,'01_15_05.c3d',3,VV,L,H,5,Same,185
683,1416,733,0.6924085,0.950783603,681,710,293,317,'01_15_01.c3d',4,VV,L,H,1,Same,29
654,1010,356,0.58866887,0.916763035,561,783,232,263,'01_15_02.c3d',4,VV,L,H,2,Same,222
753,1080,327,0.552485363,0.832368225,657,919,1,1,'01_15_03.c3d',4,VV,L,H,3,Same,262
837,1746,909,0.473135401,0.627835304,731,986,1,1,'01_15_04.c3d',4,VV,L,H,4,Same,255
1062,1529,467,0.407906216,0.683556679,887,1059,1,1,'01_15_05.c3d',4,VV,L,H,5,Same,172
678,873,195,0.828192933,1.48595487,467,632,370,361,'01_15_01.c3d',5,VV,L,H,1,Same,165
629,671,42,0.881138762,1.762530815,346,451,47,243,'01_15_02.c3d',5,VV,L,H,2,Same,105
574,783,209,0.812826713,1.695823471,430,579,256,250,'01_15_03.c3d',5,VV,L,H,3,Same,149
597,708,111,0.762221932,1.61038708,406,526,111,160,'01_15_04.c3d',5,VV,L,H,4,Same,120
618,946,328,0.830612508,1.420195145,501,475,1,277,'01_15_05.c3d',5,VV,L,H,5,Same,26
793,1635,842,0.471718468,0.894776721,744,1410,262,1,'01_15_01.c3d',6,VV,L,H,1,Same,666
822,1797,975,0.489853627,1.008317371,638,1428,1,1,'01_15_02.c3d',6,VV,L,H,2,Same,790
817,1251,434,0.4709494,0.708173906,560,966,1,1,'01_15_03.c3d',6,VV,L,H,3,Same,406
891,1441,550,0.54407657,0.757482977,682,1342,1,282,'01_15_04.c3d',6,VV,L,H,4,Same,660
879,1267,388,0.409371885,0.69700345,696,691,1,1,'01_15_05.c3d',6,VV,L,H,5,Same,5
1343,1813,470,0.297047618,0.449504406,945,1229,1,1,'01_15_01.c3d',7,VV,L,H,1,Same,284
1143,1502,359,0.302394162,0.453538314,887,948,1,261,'01_15_02.c3d',7,VV,L,H,2,Same,61
897,1432,535,0.435665569,0.540809159,788,1060,1,39,'01_15_03.c3d',7,VV,L,H,3,Same,272
727,965,238,0.473246607,0.736183665,450,668,1,35,'01_15_04.c3d',7,VV,L,H,4,Same,218
566,1063,497,0.553498378,0.576746017,424,686,1,1,'01_15_05.c3d',7,VV,L,H,5,Same,262
1249,1697,448,0.298615828,0.871981944,495,780,1,286,'01_15_01.c3d',8,VV,L,H,1,Same,285
1102,1976,874,0.364224881,0.61785474,696,847,314,329,'01_15_02.c3d',8,VV,L,H,2,Same,151
1086,1820,734,0.372016513,0.521160763,780,1164,1,325,'01_15_03.c3d',8,VV,L,H,3,Same,384
1709,2418,709,0.223479167,0.5222086,929,1049,1,1,'01_15_04.c3d',8,VV,L,H,4,Same,120
958,1415,457,0.407495043,0.653825429,712,794,275,272,'01_15_05.c3d',8,VV,L,H,5,Same,82
1236,1599,363,0.456507036,1.154547426,696,650,318,1,'01_15_01.c3d',9,VV,L,H,1,Same,46
909,2025,1116,0.590748993,0.953569637,758,717,399,367,'01_15_02.c3d',9,VV,L,H,2,Same,41
917,1165,248,0.500852552,0.803033706,725,743,359,1,'01_15_03.c3d',9,VV,L,H,3,Same,18
733,1711,978,0.752988212,1.134582206,674,661,1,298,'01_15_04.c3d',9,VV,L,H,4,Same,13
1382,2098,716,0.352213912,0.653607759,773,782,1,333,'01_15_05.c3d',9,VV,L,H,5,Same,9
793,926,133,0.670601697,2.166031565,747,704,70,335,'01_15_01.c3d',10,VV,L,H,1,Same,43
1025,1028,3,0.380123253,1.525824807,696,603,1,251,'01_15_02.c3d',10,VV,L,H,2,Same,93
961,1100,139,0.427211001,1.388417248,695,753,203,243,'01_15_03.c3d',10,VV,L,H,3,Same,58
674,934,260,0.594942549,1.079176245,359,648,1,1,'01_15_04.c3d',10,VV,L,H,4,Same,289
1429,2469,1040,0.632262411,1.651841073,336,492,48,116,'01_15_05.c3d',10,VV,L,H,5,Same,156
1085,1828,743,0.423354819,0.609980431,936,1475,1,1,'01_15_01.c3d',11,VV,L,H,1,Same,539
987,1350,363,0.427139229,0.745464792,900,1272,1,1,'01_15_02.c3d',11,VV,L,H,2,Same,372
1566,2002,436,0.25501203,0.494459611,1470,1484,1,1,'01_15_03.c3d',11,VV,L,H,3,Same,14
1757,3066,1309,0.31075923,0.532367921,1534,1768,1,465,'01_15_04.c3d',11,VV,L,H,4,Same,234
1208,2165,957,0.319816385,0.552031042,994,1272,1,339,'01_15_05.c3d',11,VV,L,H,5,Same,278
666,1511,845,0.620834739,1.256810644,583,657,241,256,'01_15_01.c3d',12,VV,L,H,1,Same,74
756,1097,341,0.540291306,0.954217854,472,762,298,295,'01_15_02.c3d',12,VV,L,H,2,Same,290
724,1264,540,0.594441124,1.013082019,658,714,281,301,'01_15_03.c3d',12,VV,L,H,3,Same,56
764,1039,275,0.465212624,0.886435238,405,688,1,1,'01_15_04.c3d',12,VV,L,H,4,Same,283
738,1719,981,0.409143776,0.77608368,696,760,1,175,'01_15_05.c3d',12,VV,L,H,5,Same,64
803,1044,241,0.637813654,0.955534274,618,777,1,1,'01_15_01.c3d',13,VV,L,H,1,Same,159
919,1229,310,0.551388878,0.885121646,751,862,340,110,'01_15_02.c3d',13,VV,L,H,2,Same,111
797,1121,324,0.532789087,0.984078809,589,779,246,272,'01_15_03.c3d',13,VV,L,H,3,Same,190
683,1115,432,0.542869196,0.829451524,516,620,1,126,'01_15_04.c3d',13,VV,L,H,4,Same,104
799,1248,449,0.547763923,0.996758138,740,758,273,295,'01_15_05.c3d',13,VV,L,H,5,Same,18
575,719,144,0.730904679,1.775861609,396,529,1,250,'01_15_01.c3d',14,VV,L,H,1,Same,133
457,814,357,0.894854467,1.5519022,368,545,1,175,'01_15_02.c3d',14,VV,L,H,2,Same,177
467,772,305,0.826834336,1.618297954,312,498,142,1,'01_15_03.c3d',14,VV,L,H,3,Same,186
730,896,166,0.662865324,1.407500059,544,636,264,295,'01_15_04.c3d',14,VV,L,H,4,Same,92
582,794,212,0.675328669,1.420840036,483,607,1,221,'01_15_05.c3d',14,VV,L,H,5,Same,124
884,1149,265,0.498067535,1.113921523,609,831,1,342,'01_15_01.c3d',15,VV,L,H,1,Same,222
821,1016,195,0.490948886,1.226194885,623,811,1,266,'01_15_02.c3d',15,VV,L,H,2,Same,188
866,1095,229,0.524913984,1.055555761,684,771,1,329,'01_15_03.c3d',15,VV,L,H,3,Same,87
796,1062,266,0.498922123,1.041142216,592,807,223,1,'01_15_04.c3d',15,VV,L,H,4,Same,215
966,1227,261,0.380767385,0.967019106,685,905,190,213,'01_15_05.c3d',15,VV,L,H,5,Same,220
919,1231,312,0.531677425,1.032901486,582,652,1,216,'01_15_01.c3d',16,VV,L,H,1,Same,70
919,1151,232,0.476852278,1.170808201,575,693,139,1,'01_15_02.c3d',16,VV,L,H,2,Same,118
1056,1157,101,0.37995836,0.919232891,653,972,1,164,'01_15_03.c3d',16,VV,L,H,3,Same,319
1168,1419,251,0.328470679,0.834239872,621,858,200,240,'01_15_04.c3d',16,VV,L,H,4,Same,237
912,1039,127,0.344941347,0.915174558,401,773,1,1,'01_15_05.c3d',16,VV,L,H,5,Same,372
556,1306,750,0.86952713,1.344905461,443,551,1,1,'01_15_01.c3d',17,VV,L,H,1,Same,108
476,918,442,1.057390475,1.886333205,332,500,229,1,'01_15_02.c3d',17,VV,L,H,2,Same,168
704,1384,680,0.651471762,1.331998902,371,505,1,1,'01_15_03.c3d',17,VV,L,H,3,Same,134
575,889,314,0.679720488,1.512114576,465,551,241,263,'01_15_04.c3d',17,VV,L,H,4,Same,86
604,758,154,0.629203172,1.586950019,455,531,240,246,'01_15_05.c3d',17,VV,L,H,5,Same,76
987,1015,28,0.564248301,1.422495881,637,763,1,31,'01_15_01.c3d',18,VV,L,H,1,Same,126
1464,1717,253,0.719428994,1.301753261,627,817,1,1,'01_15_02.c3d',18,VV,L,H,2,Same,190
855,1084,229,0.62867991,1.536015159,559,757,129,1,'01_15_03.c3d',18,VV,L,H,3,Same,198
929,1372,443,0.571441531,1.396367589,562,679,1,215,'01_15_04.c3d',18,VV,L,H,4,Same,117
885,890,5,0.647165997,1.028925893,376,664,1,1,'01_15_05.c3d',18,VV,L,H,5,Same,288
928,1162,234,0.45420921,0.884729861,705,917,295,302,'01_15_01.c3d',19,VV,L,H,1,Same,212
1075,1142,67,0.356297325,1.1211847,787,752,1,280,'01_15_02.c3d',19,VV,L,H,2,Same,35
869,1287,418,0.476043531,0.834237395,716,789,127,240,'01_15_03.c3d',19,VV,L,H,3,Same,73
899,965,66,0.52766715,1.039674812,664,669,1,244,'01_15_04.c3d',19,VV,L,H,4,Same,5
993,1211,218,0.538566545,1.019078883,699,663,1,165,'01_15_05.c3d',19,VV,L,H,5,Same,36
1283,2301,1018,0.446213052,0.772962913,888,1159,431,464,'01_15_01.c3d',20,VV,L,H,1,Same,271
784,1532,748,0.658803661,1.063562219,626,838,1,282,'01_15_02.c3d',20,VV,L,H,2,Same,212
893,994,101,0.610477217,1.186828177,659,665,316,314,'01_15_03.c3d',20,VV,L,H,3,Same,6
854,1214,360,0.607367128,0.982938915,639,842,307,295,'01_15_04.c3d',20,VV,L,H,4,Same,203
811,1123,312,0.559366738,0.909226341,538,653,1,1,'01_15_05.c3d',20,VV,L,H,5,Same,115
782,1273,491,0.545167095,0.717548762,644,781,1,305,'01_15_01.c3d',21,VV,L,H,1,Same,137
965,1477,512,0.455352945,0.578337451,828,1239,422,1,'01_15_02.c3d',21,VV,L,H,2,Same,411
982,1448,466,0.431057688,0.65669435,770,861,1,1,'01_15_03.c3d',21,VV,L,H,3,Same,91
790,1199,409,0.573860211,0.693326319,649,760,280,269,'01_15_04.c3d',21,VV,L,H,4,Same,111
888,1370,482,0.414978854,0.595914235,635,1194,1,1,'01_15_05.c3d',21,VV,L,H,5,Same,559
871,1409,538,0.564291854,0.852615258,678,926,1,1,'01_15_01.c3d',22,VV,L,H,1,Same,248
863,1616,753,0.612610083,0.997322647,662,1375,1,410,'01_15_02.c3d',22,VV,L,H,2,Same,713
950,1361,411,0.522842253,1.012335543,718,1061,304,1,'01_15_03.c3d',22,VV,L,H,3,Same,343
905,1547,642,0.520071008,1.033755289,694,1325,289,381,'01_15_04.c3d',22,VV,L,H,4,Same,631
977,1770,793,0.485857148,0.923039759,732,1548,311,435,'01_15_05.c3d',22,VV,L,H,5,Same,816
1046,2512,1466,0.40216583,0.55021335,829,1532,1,275,'01_15_01.c3d',23,VV,L,H,1,Same,703
1564,3786,2222,0.273489864,0.429305262,1384,2523,440,1,'01_15_02.c3d',23,VV,L,H,2,Same,1139
1013,1761,748,0.365283094,0.602687622,836,1505,249,1,'01_15_03.c3d',23,VV,L,H,3,Same,669
1549,2861,1312,0.303482951,0.455059381,1412,2205,1,404,'01_15_04.c3d',23,VV,L,H,4,Same,793
1203,2192,989,0.300126036,0.460759053,1001,1536,1,219,'01_15_05.c3d',23,VV,L,H,5,Same,535
823,1031,208,0.489337385,1.008641502,663,795,1,283,'01_15_01.c3d',24,VV,L,H,1,Same,132
852,1047,195,0.414985948,1.065774102,774,645,228,1,'01_15_02.c3d',24,VV,L,H,2,Same,129
842,1035,193,0.485162213,1.073747784,603,813,1,256,'01_15_03.c3d',24,VV,L,H,3,Same,210
782,1099,317,0.503464652,0.835983922,555,834,3,1,'01_15_04.c3d',24,VV,L,H,4,Same,279
889,1157,268,0.41875289,0.814699084,623,918,114,210,'01_15_05.c3d',24,VV,L,H,5,Same,295
672,1151,479,0.671421093,1.030847791,570,661,232,1,'01_15_01.c3d',25,VV,L,H,1,Same,91
853,1016,163,0.553909059,0.997098682,688,707,294,295,'01_15_02.c3d',25,VV,L,H,2,Same,19
653,1114,461,0.712376113,1.09817535,503,526,217,226,'01_15_03.c3d',25,VV,L,H,3,Same,23
860,1296,436,0.477918081,0.810243992,676,624,104,308,'01_15_04.c3d',25,VV,L,H,4,Same,52
744,1172,428,0.577031638,0.811548384,591,667,1,241,'01_15_05.c3d',25,VV,L,H,5,Same,76
1254,1867,613,0.347025675,0.810575756,919,804,1,417,'01_15_01.c3d',26,VV,L,H,1,Same,115
873,1055,182,0.371049723,0.769689639,661,752,273,268,'01_15_02.c3d',26,VV,L,H,2,Same,91
2828,3504,676,0.174289735,0.627429901,2515,898,1,1,'01_15_03.c3d',26,VV,L,H,3,Same,1617
889,2774,1885,0.395522182,0.502929037,700,1013,266,1,'01_15_04.c3d',26,VV,L,H,4,Same,313
1807,1930,123,0.136584682,0.360194966,744,1620,30,1,'01_15_05.c3d',26,VV,L,H,5,Same,876
1449,1490,41,0.338799583,0.751089111,848,943,1,1,'01_15_01.c3d',27,VV,L,H,1,Same,95
997,1321,324,0.636881795,0.991381694,726,916,1,376,'01_15_02.c3d',27,VV,L,H,2,Same,190
1245,1760,515,0.504006485,0.810569959,935,1084,1,1,'01_15_03.c3d',27,VV,L,H,3,Same,149
986,1649,663,0.497499536,0.604626985,692,1465,311,325,'01_15_04.c3d',27,VV,L,H,4,Same,773
1062,1416,354,0.510980678,0.819324775,759,990,1,383,'01_15_05.c3d',27,VV,L,H,5,Same,231
934,2101,1167,0.516733992,0.878696932,640,1859,274,1,'01_15_01.c3d',28,VV,L,H,1,Same,1219
1108,2486,1378,0.503385862,0.730915016,870,1971,1,416,'01_15_02.c3d',28,VV,L,H,2,Same,1101
2083,2584,501,0.34565032,0.575452893,2041,2277,1,385,'01_15_03.c3d',28,VV,L,H,3,Same,236
941,1542,601,0.465980927,0.738675946,830,1311,1,278,'01_15_04.c3d',28,VV,L,H,4,Same,481
989,1383,394,0.444236373,0.760395373,777,1051,261,311,'01_15_05.c3d',28,VV,L,H,5,Same,274
857,1799,942,0.444162927,1.088584456,677,652,44,1,'01_15_01.c3d',29,VV,L,H,1,Same,25
685,825,140,0.553927122,1.313092047,556,612,1,213,'01_15_02.c3d',29,VV,L,H,2,Same,56
779,969,190,0.428410176,0.970743283,638,698,178,206,'01_15_03.c3d',29,VV,L,H,3,Same,60
888,1306,418,0.414190991,0.713544943,717,834,1,1,'01_15_04.c3d',29,VV,L,H,4,Same,117
777,1757,980,0.426681323,1.018119446,660,662,1,264,'01_15_05.c3d',29,VV,L,H,5,Same,2
815,1864,1049,0.556126372,0.680088407,760,900,1,332,'01_15_01.c3d',30,VV,L,H,1,Same,140
1022,1394,372,0.378564765,0.669655864,713,757,1,1,'01_15_02.c3d',30,VV,L,H,2,Same,44
998,1362,364,0.403943467,0.67627769,769,809,257,1,'01_15_03.c3d',30,VV,L,H,3,Same,40
738,1034,296,0.35910743,0.62635094,369,649,1,1,'01_15_04.c3d',30,VV,L,H,4,Same,280
862,1175,313,0.356925292,0.722462173,513,744,72,217,'01_15_05.c3d',30,VV,L,H,5,Same,231
854,1028,174,0.823977423,1.387830422,674,710,387,383,'01_15_01.c3d',31,VV,L,H,1,Same,36
731,1036,305,0.813459857,1.391624938,645,655,290,304,'01_15_02.c3d',31,VV,L,H,2,Same,10
709,1777,1068,1.069593109,1.71536237,638,649,346,1,'01_15_03.c3d',31,VV,L,H,3,Same,11
766,1435,669,0.807262238,1.343849672,612,666,332,334,'01_15_04.c3d',31,VV,L,H,4,Same,54
1054,1252,198,0.629662201,1.068381756,831,918,1,412,'01_15_05.c3d',31,VV,L,H,5,Same,87
727,1092,365,0.624630873,0.919550599,627,731,1,1,'01_15_01.c3d',32,VV,L,H,1,Same,104
872,1107,235,0.543549821,0.996512583,653,815,1,1,'01_15_02.c3d',32,VV,L,H,2,Same,162
833,1236,403,0.576011971,0.793215873,667,875,275,282,'01_15_03.c3d',32,VV,L,H,3,Same,208
983,1372,389,0.444957295,0.802810434,818,890,283,312,'01_15_04.c3d',32,VV,L,H,4,Same,72
1096,1594,498,0.37403848,0.755101098,838,921,278,1,'01_15_05.c3d',32,VV,L,H,5,Same,83
906,1269,363,0.534730701,0.788946513,756,849,275,1,'01_15_01.c3d',33,VV,L,H,1,Same,93
1254,1398,144,0.50557615,0.968580409,1176,1118,643,577,'01_15_02.c3d',33,VV,L,H,2,Same,58
910,1401,491,0.458886652,0.676907274,649,1005,269,217,'01_15_03.c3d',33,VV,L,H,3,Same,356
866,1378,512,0.582889286,0.785277595,702,1054,292,1,'01_15_04.c3d',33,VV,L,H,4,Same,352
990,1522,532,0.530551732,0.736489097,822,1202,359,1,'01_15_05.c3d',33,VV,L,H,5,Same,380
1082,2755,1673,0.295715538,1.284034366,755,905,23,411,'01_15_01.c3d',34,VV,L,H,1,Same,150
837,977,140,0.74606224,1.261445082,649,734,330,329,'01_15_02.c3d',34,VV,L,H,2,Same,85
720,741,21,0.63332361,1.3324912,529,575,31,241,'01_15_03.c3d',34,VV,L,H,3,Same,46
676,930,254,0.641686784,0.994742764,576,617,1,269,'01_15_04.c3d',34,VV,L,H,4,Same,41
738,1008,270,0.491508981,0.869546459,564,567,1,219,'01_15_05.c3d',34,VV,L,H,5,Same,3
1096,1197,101,0.454536093,0.914230819,551,799,1,1,'01_15_01.c3d',35,VV,L,H,1,Same,248
1162,1372,210,0.498413387,0.794435613,771,1058,1,465,'01_15_02.c3d',35,VV,L,H,2,Same,287
802,1350,548,0.61435425,0.892655862,600,879,1,1,'01_15_03.c3d',35,VV,L,H,3,Same,279
869,1097,228,0.457885924,0.903546794,509,548,197,220,'01_15_04.c3d',35,VV,L,H,4,Same,39
690,1218,528,0.620472204,0.841400974,380,511,79,119,'01_15_05.c3d',35,VV,L,H,5,Same,131
865,1626,761,0.767448598,0.718930891,784,721,1,1,'01_16_01.c3d',1,VV,R,E,1,Same,63
1162,1458,296,1.177910339,0.413917054,1039,752,476,1,'01_16_02.c3d',1,VV,R,E,2,Same,287
809,1904,1095,1.08031679,0.653824513,750,694,285,24,'01_16_03.c3d',1,VV,R,E,3,Same,56
868,1292,424,0.911719542,0.490091534,610,660,1,1,'01_16_04.c3d',1,VV,R,E,4,Same,50
686,1575,889,1.21510708,0.746935097,572,600,200,1,'01_16_05.c3d',1,VV,R,E,5,Same,28
860,2091,1231,0.72292015,0.6710558,1075,761,242,1,'01_16_01.c3d',2,VV,R,E,1,Same,314
854,1323,469,0.64572703,0.559920253,917,540,258,1,'01_16_02.c3d',2,VV,R,E,2,Same,377
811,1141,330,0.823369476,0.707712206,881,671,350,1,'01_16_03.c3d',2,VV,R,E,3,Same,210
892,1125,233,0.768775795,0.592238588,852,714,269,1,'01_16_04.c3d',2,VV,R,E,4,Same,138
811,1128,317,0.8767217,0.757542292,803,716,265,1,'01_16_05.c3d',2,VV,R,E,5,Same,87
507,758,251,1.135302736,0.945454052,486,408,156,1,'01_16_01.c3d',3,VV,R,E,1,Same,78
1176,1870,694,0.923576049,0.622855733,1127,945,695,1,'01_16_02.c3d',3,VV,R,E,2,Same,182
719,780,61,1.242169366,0.837168876,676,466,89,21,'01_16_03.c3d',3,VV,R,E,3,Same,210
818,968,150,1.098191139,0.614313038,657,554,297,1,'01_16_04.c3d',3,VV,R,E,4,Same,103
829,1036,207,1.200982176,0.691009938,713,776,1,1,'01_16_05.c3d',3,VV,R,E,5,Same,63
744,1441,697,1.18600637,0.788339016,684,682,350,1,'01_16_01.c3d',4,VV,R,E,1,Same,2
651,1468,817,1.065958478,0.718397929,659,534,250,242,'01_16_02.c3d',4,VV,R,E,2,Same,125
718,979,261,0.880291416,0.608809639,676,641,239,1,'01_16_03.c3d',4,VV,R,E,3,Same,35
854,1496,642,0.862382377,0.485410065,680,718,1,1,'01_16_04.c3d',4,VV,R,E,4,Same,38
798,1040,242,0.876835087,0.585264651,672,611,1,1,'01_16_05.c3d',4,VV,R,E,5,Same,61
611,1815,1204,1.972372327,0.957836534,561,578,311,263,'01_16_01.c3d',5,VV,R,E,1,Same,17
618,1185,567,1.856866065,1.162380429,578,597,346,319,'01_16_02.c3d',5,VV,R,E,2,Same,19
560,1024,464,1.418382796,1.066958492,554,512,292,261,'01_16_03.c3d',5,VV,R,E,3,Same,42
732,888,156,1.731380316,0.998576789,593,560,1,245,'01_16_04.c3d',5,VV,R,E,4,Same,33
638,737,99,1.496685898,0.787544315,549,417,1,14,'01_16_05.c3d',5,VV,R,E,5,Same,132
828,1600,772,1.113376041,0.750164102,1419,620,1,1,'01_16_01.c3d',6,VV,R,E,1,Same,799
715,1350,635,1.114325005,0.82286781,952,600,506,1,'01_16_02.c3d',6,VV,R,E,2,Same,352
747,1477,730,0.881633868,0.690037976,1301,576,1,368,'01_16_03.c3d',6,VV,R,E,3,Same,725
784,1404,620,0.809532291,0.675412308,1077,556,297,1,'01_16_04.c3d',6,VV,R,E,4,Same,521
753,940,187,1.025743484,0.597987836,762,636,278,1,'01_16_05.c3d',6,VV,R,E,5,Same,126
722,970,248,0.948619682,0.495151097,682,568,1,255,'01_16_01.c3d',7,VV,R,E,1,Same,114
672,1455,783,0.89669629,0.531695496,636,594,220,1,'01_16_02.c3d',7,VV,R,E,2,Same,42
760,1908,1148,0.781751171,0.537796458,689,598,240,1,'01_16_03.c3d',7,VV,R,E,3,Same,91
764,1041,277,1.078400135,0.477526568,576,636,268,1,'01_16_04.c3d',7,VV,R,E,4,Same,60
630,874,244,1.105864321,0.551413454,558,486,1,1,'01_16_05.c3d',7,VV,R,E,5,Same,72
1034,1334,300,0.71086684,0.560524089,1037,679,288,265,'01_16_01.c3d',8,VV,R,E,1,Same,358
827,1325,498,0.676653641,0.604055814,733,668,1,1,'01_16_02.c3d',8,VV,R,E,2,Same,65
1134,1784,650,0.771719151,0.503007222,1013,939,476,1,'01_16_03.c3d',8,VV,R,E,3,Same,74
704,1420,716,0.863167375,0.725222176,644,591,252,1,'01_16_04.c3d',8,VV,R,E,4,Same,53
717,1373,656,0.86161075,0.615877256,593,614,186,181,'01_16_05.c3d',8,VV,R,E,5,Same,21
965,1704,739,0.863605863,0.870427663,768,538,286,262,'01_16_01.c3d',9,VV,R,E,1,Same,230
683,1710,1027,0.603193565,0.685685394,685,530,1,31,'01_16_02.c3d',9,VV,R,E,2,Same,155
707,1609,902,0.837623452,0.717282982,647,625,306,301,'01_16_03.c3d',9,VV,R,E,3,Same,22
684,1161,477,0.855718227,0.710218925,553,401,246,258,'01_16_04.c3d',9,VV,R,E,4,Same,152
839,1829,990,0.836668999,0.65565173,677,669,1,398,'01_16_05.c3d',9,VV,R,E,5,Same,8
816,877,61,1.803734622,1.119480292,614,602,1,380,'01_16_01.c3d',10,VV,R,E,1,Same,12
680,731,51,2.496591023,1.37984707,614,591,422,414,'01_16_02.c3d',10,VV,R,E,2,Same,23
676,776,100,1.448007069,1.090754271,600,531,241,230,'01_16_03.c3d',10,VV,R,E,3,Same,69
505,750,245,1.489056602,1.33371388,464,466,207,120,'01_16_04.c3d',10,VV,R,E,4,Same,2
809,1157,348,0.752536173,0.588659852,416,427,8,54,'01_16_05.c3d',10,VV,R,E,5,Same,11
872,1581,709,0.708275177,0.553811908,737,790,1,1,'01_16_01.c3d',11,VV,R,E,1,Same,53
1004,1572,568,0.604841932,0.459617182,1035,913,1,1,'01_16_02.c3d',11,VV,R,E,2,Same,122
1117,1233,116,0.703925149,0.39493204,927,836,351,1,'01_16_03.c3d',11,VV,R,E,3,Same,91
937,1634,697,0.603468689,0.55351444,945,866,1,1,'01_16_04.c3d',11,VV,R,E,4,Same,79
919,1311,392,0.603787293,0.464687179,1066,779,292,1,'01_16_05.c3d',11,VV,R,E,5,Same,287
752,921,169,0.960996153,0.633665095,719,469,293,270,'01_16_01.c3d',12,VV,R,E,1,Same,250
781,816,35,1.317544692,0.604145342,653,671,298,316,'01_16_02.c3d',12,VV,R,E,2,Same,18
803,959,156,0.972772252,0.570872747,697,718,287,290,'01_16_03.c3d',12,VV,R,E,3,Same,21
782,1038,256,0.916799983,0.62416203,712,517,326,319,'01_16_04.c3d',12,VV,R,E,4,Same,195
948,1876,928,0.737813831,0.49743567,812,932,365,1,'01_16_05.c3d',12,VV,R,E,5,Same,120
764,1289,525,1.311069514,0.716906536,677,655,1,1,'01_16_01.c3d',13,VV,R,E,1,Same,22
759,939,180,1.59994673,0.763816085,621,550,271,258,'01_16_02.c3d',13,VV,R,E,2,Same,71
734,1229,495,1.585771253,0.843265544,610,534,1,1,'01_16_03.c3d',13,VV,R,E,3,Same,76
799,921,122,1.244716782,0.550605318,702,602,287,35,'01_16_04.c3d',13,VV,R,E,4,Same,100
743,1323,580,1.27104034,0.919345175,647,619,340,1,'01_16_05.c3d',13,VV,R,E,5,Same,28
1744,2581,837,0.850746974,0.431577727,1498,1174,1,1,'01_16_01.c3d',14,VV,R,E,1,Same,324
580,712,132,1.373822166,1.047944801,509,505,233,138,'01_16_02.c3d',14,VV,R,E,2,Same,4
512,654,142,1.547120354,1.113852751,463,416,191,1,'01_16_03.c3d',14,VV,R,E,3,Same,47
662,767,105,1.259764635,0.792494323,456,413,192,1,'01_16_04.c3d',14,VV,R,E,4,Same,43
767,791,24,1.587654094,0.696934697,598,470,267,1,'01_16_05.c3d',14,VV,R,E,5,Same,128
729,924,195,1.02959521,0.669309031,682,556,1,1,'01_16_01.c3d',15,VV,R,E,1,Same,126
610,760,150,1.098779869,0.697833614,594,400,1,1,'01_16_02.c3d',15,VV,R,E,2,Same,194
691,1088,397,0.915930317,0.708536862,506,579,203,169,'01_16_03.c3d',15,VV,R,E,3,Same,73
655,926,271,0.942512175,0.624332509,575,409,130,1,'01_16_04.c3d',15,VV,R,E,4,Same,166
690,945,255,1.05503054,0.75679316,629,590,262,130,'01_16_05.c3d',15,VV,R,E,5,Same,39
696,1330,634,1.102370974,0.825855424,602,508,302,252,'01_16_01.c3d',16,VV,R,E,1,Same,94
983,1210,227,0.957623134,0.572420864,757,627,251,1,'01_16_02.c3d',16,VV,R,E,2,Same,130
792,1503,711,0.85373675,0.672369885,763,709,287,29,'01_16_03.c3d',16,VV,R,E,3,Same,54
873,1383,510,0.808601357,0.980868299,510,365,1,12,'01_16_04.c3d',16,VV,R,E,4,Same,145
991,1073,82,0.683899541,0.31491827,631,407,1,1,'01_16_05.c3d',16,VV,R,E,5,Same,224
529,1721,1192,2.14513232,0.860911216,515,348,243,238,'01_16_01.c3d',17,VV,R,E,1,Same,167
529,1166,637,1.855019448,1.052024311,514,486,291,285,'01_16_02.c3d',17,VV,R,E,2,Same,28
544,686,142,1.560472619,1.149794169,540,368,269,261,'01_16_03.c3d',17,VV,R,E,3,Same,172
593,1151,558,1.480110578,0.84708685,623,513,280,1,'01_16_04.c3d',17,VV,R,E,4,Same,110
576,605,29,1.831044198,0.982568876,394,453,284,277,'01_16_05.c3d',17,VV,R,E,5,Same,59
733,1418,685,1.270568908,0.784285366,691,687,284,291,'01_16_01.c3d',18,VV,R,E,1,Same,4
1338,2002,664,1.356123121,1.138767286,603,664,1,1,'01_16_02.c3d',18,VV,R,E,2,Same,61
509,1655,1146,1.284235175,1.021173013,594,431,1,1,'01_16_03.c3d',18,VV,R,E,3,Same,163
504,1856,1352,1.326558825,1.074640341,512,470,1,1,'01_16_04.c3d',18,VV,R,E,4,Same,42
761,1157,396,1.122332222,1.056581022,520,494,1,1,'01_16_05.c3d',18,VV,R,E,5,Same,26
771,1281,510,0.761071727,0.78899603,706,717,1,282,'01_16_01.c3d',19,VV,R,E,1,Same,11
748,1241,493,0.808907267,0.875165818,753,699,1,1,'01_16_02.c3d',19,VV,R,E,2,Same,54
628,763,135,1.243846257,0.725542014,597,554,1,118,'01_16_03.c3d',19,VV,R,E,3,Same,43
622,917,295,1.019912621,0.728930886,635,545,254,1,'01_16_04.c3d',19,VV,R,E,4,Same,90
782,1466,684,0.70726738,0.697252838,805,636,1,1,'01_16_05.c3d',19,VV,R,E,5,Same,169
751,1446,695,0.924118408,0.84699436,727,679,319,1,'01_16_01.c3d',20,VV,R,E,1,Same,48
705,1059,354,0.944507683,0.736774642,615,576,1,1,'01_16_02.c3d',20,VV,R,E,2,Same,39
734,1728,994,1.341526324,0.966712198,703,688,340,1,'01_16_03.c3d',20,VV,R,E,3,Same,15
784,1245,461,0.930613045,0.844219012,722,685,1,341,'01_16_04.c3d',20,VV,R,E,4,Same,37
926,1398,472,0.659682157,0.537707299,761,647,289,1,'01_16_05.c3d',20,VV,R,E,5,Same,114
869,1013,144,1.044082956,0.478834253,770,745,357,328,'01_16_01.c3d',21,VV,R,E,1,Same,25
757,1448,691,0.9282495,0.611420133,823,663,304,252,'01_16_02.c3d',21,VV,R,E,2,Same,160
914,1047,133,1.046694778,0.588277497,822,763,368,323,'01_16_03.c3d',21,VV,R,E,3,Same,59
797,1146,349,0.780338939,0.495924124,853,666,302,1,'01_16_04.c3d',21,VV,R,E,4,Same,187
925,1294,369,0.572138516,0.414068135,815,653,1,1,'01_16_05.c3d',21,VV,R,E,5,Same,162
888,1575,687,0.736347819,0.929170914,1072,751,400,429,'01_16_01.c3d',22,VV,R,E,1,Same,321
956,1468,512,0.699231959,0.740441514,1211,762,360,384,'01_16_02.c3d',22,VV,R,E,2,Same,449
991,1610,619,0.620784231,0.769045376,850,718,369,371,'01_16_03.c3d',22,VV,R,E,3,Same,132
971,1535,564,0.591313314,0.622372714,924,739,358,1,'01_16_04.c3d',22,VV,R,E,4,Same,185
918,1272,354,0.780827205,0.627258418,719,749,259,296,'01_16_05.c3d',22,VV,R,E,5,Same,30
857,1467,610,0.53304942,0.663531276,1162,766,229,239,'01_16_01.c3d',23,VV,R,E,1,Same,396
924,1401,477,0.702000823,0.669193271,1171,791,1,343,'01_16_02.c3d',23,VV,R,E,2,Same,380
1594,1610,16,0.551461604,0.520223203,1049,836,288,325,'01_16_03.c3d',23,VV,R,E,3,Same,213
1013,1570,557,0.49939024,0.363391101,989,658,262,1,'01_16_04.c3d',23,VV,R,E,4,Same,331
1552,2016,464,0.462174563,0.309910709,1353,1249,284,1,'01_16_05.c3d',23,VV,R,E,5,Same,104
737,779,42,1.449042192,0.620054368,626,647,249,227,'01_16_01.c3d',24,VV,R,E,1,Same,21
790,912,122,1.165590357,0.714016844,635,712,303,1,'01_16_02.c3d',24,VV,R,E,2,Same,77
955,963,8,1.073352152,0.522800759,691,619,339,1,'01_16_03.c3d',24,VV,R,E,3,Same,72
624,1250,626,1.084231936,0.676808603,724,592,1,1,'01_16_04.c3d',24,VV,R,E,4,Same,132
636,836,200,1.123409315,0.643734789,561,444,191,183,'01_16_05.c3d',24,VV,R,E,5,Same,117
690,883,193,1.120162963,0.706873191,668,612,240,226,'01_16_01.c3d',25,VV,R,E,1,Same,56
856,2206,1350,1.176234514,0.611826254,828,762,420,1,'01_16_02.c3d',25,VV,R,E,2,Same,66
591,1440,849,1.157265496,0.85531553,632,549,242,228,'01_16_03.c3d',25,VV,R,E,3,Same,83
656,1087,431,1.166523168,0.681764695,629,600,266,269,'01_16_04.c3d',25,VV,R,E,4,Same,29
774,1280,506,1.049174864,0.671011351,813,707,328,242,'01_16_05.c3d',25,VV,R,E,5,Same,106
769,1068,299,0.959128238,0.583925187,770,518,317,296,'01_16_01.c3d',26,VV,R,E,1,Same,252
1285,1987,702,0.672674163,0.443650526,1095,701,357,1,'01_16_02.c3d',26,VV,R,E,2,Same,394
668,1954,1286,0.661878711,0.553874062,706,578,265,1,'01_16_03.c3d',26,VV,R,E,3,Same,128
1238,2546,1308,0.716779316,0.429793608,1083,627,274,248,'01_16_04.c3d',26,VV,R,E,4,Same,456
1170,1351,181,0.54470373,0.301785982,1024,831,276,37,'01_16_05.c3d',26,VV,R,E,5,Same,193
821,1197,376,1.079214831,0.810602163,866,712,1,1,'01_16_01.c3d',27,VV,R,E,1,Same,154
1055,1410,355,0.978929944,0.698472359,993,910,558,1,'01_16_02.c3d',27,VV,R,E,2,Same,83
944,1396,452,0.874109789,0.688382836,757,796,380,1,'01_16_03.c3d',27,VV,R,E,3,Same,39
1220,1242,22,0.893561429,0.539802879,932,749,1,360,'01_16_04.c3d',27,VV,R,E,4,Same,183
982,1231,249,1.082622283,0.766214127,835,846,440,1,'01_16_05.c3d',27,VV,R,E,5,Same,11
1038,2255,1217,0.716227598,0.48575882,1733,744,1,353,'01_16_01.c3d',28,VV,R,E,1,Same,989
850,1621,771,0.685912935,0.635270718,1205,663,1,1,'01_16_02.c3d',28,VV,R,E,2,Same,542
1139,2076,937,0.861320069,0.593592733,938,1865,270,1405,'01_16_03.c3d',28,VV,R,E,3,Same,927
794,1262,468,0.86501494,0.645100896,766,638,1,258,'01_16_04.c3d',28,VV,R,E,4,Same,128
884,1626,742,0.912355402,0.573618977,896,799,274,1,'01_16_05.c3d',28,VV,R,E,5,Same,97
613,1544,931,1.663233801,0.863486115,586,543,284,1,'01_16_01.c3d',29,VV,R,E,1,Same,43
634,967,333,1.311952336,0.718734063,656,612,287,260,'01_16_02.c3d',29,VV,R,E,2,Same,44
681,1421,740,1.126881975,0.7724536,621,643,37,1,'01_16_03.c3d',29,VV,R,E,3,Same,22
762,875,113,1.123277794,0.705326203,648,522,1,1,'01_16_04.c3d',29,VV,R,E,4,Same,126
747,905,158,0.993378816,0.589391691,681,539,244,1,'01_16_05.c3d',29,VV,R,E,5,Same,142
1015,1981,966,0.822732223,0.469548631,901,836,1,1,'01_16_01.c3d',30,VV,R,E,1,Same,65
693,1107,414,0.90263419,0.617072411,752,659,1,1,'01_16_02.c3d',30,VV,R,E,2,Same,93
858,1323,465,0.673486714,0.491788815,767,696,149,1,'01_16_03.c3d',30,VV,R,E,3,Same,71
734,1002,268,0.776764865,0.452235149,653,517,48,1,'01_16_04.c3d',30,VV,R,E,4,Same,136
807,1431,624,0.804125517,0.463186672,785,557,173,1,'01_16_05.c3d',30,VV,R,E,5,Same,228
574,1328,754,1.342608278,1.302788576,748,536,287,272,'01_16_01.c3d',31,VV,R,E,1,Same,212
582,1346,764,1.936782562,1.230142988,651,502,297,285,'01_16_02.c3d',31,VV,R,E,2,Same,149
692,1412,720,1.664663711,0.885543461,618,497,339,245,'01_16_03.c3d',31,VV,R,E,3,Same,121
751,1008,257,1.482140339,0.769946639,687,488,332,1,'01_16_04.c3d',31,VV,R,E,4,Same,199
702,789,87,1.951235542,0.91750802,597,467,268,248,'01_16_05.c3d',31,VV,R,E,5,Same,130
832,971,139,1.162392225,0.649487361,629,650,1,1,'01_16_01.c3d',32,VV,R,E,1,Same,21
801,1195,394,1.017438275,0.685978525,770,751,381,1,'01_16_02.c3d',32,VV,R,E,2,Same,19
959,1087,128,1.03266726,0.562377036,711,740,331,1,'01_16_03.c3d',32,VV,R,E,3,Same,29
1012,1251,239,0.796910059,0.551894167,768,709,263,1,'01_16_04.c3d',32,VV,R,E,4,Same,59
962,972,10,1.099955122,0.545494078,714,683,315,292,'01_16_05.c3d',32,VV,R,E,5,Same,31
2026,2340,314,0.459444581,0.306521078,1702,1442,693,1,'01_16_01.c3d',33,VV,R,E,1,Same,260
949,1728,779,0.615222504,0.65090361,1180,833,381,377,'01_16_02.c3d',33,VV,R,E,2,Same,347
843,1627,784,1.05353859,0.697764111,919,812,398,320,'01_16_03.c3d',33,VV,R,E,3,Same,107
992,1969,977,0.912726587,0.665698461,1043,906,442,407,'01_16_04.c3d',33,VV,R,E,4,Same,137
929,1262,333,0.892385705,0.584620046,1102,746,358,319,'01_16_05.c3d',33,VV,R,E,5,Same,356
941,1445,504,0.763433895,0.574413707,884,821,437,1,'01_16_01.c3d',34,VV,R,E,1,Same,63
762,874,112,1.372699976,0.708602832,706,646,343,317,'01_16_02.c3d',34,VV,R,E,2,Same,60
615,854,239,1.130225107,0.666351318,573,569,245,241,'01_16_03.c3d',34,VV,R,E,3,Same,4
713,1124,411,0.791104742,0.613894659,673,628,265,230,'01_16_04.c3d',34,VV,R,E,4,Same,45
561,1106,545,0.846772575,0.686143347,573,484,203,1,'01_16_05.c3d',34,VV,R,E,5,Same,89
677,1253,576,1.429875611,0.698266542,602,471,240,235,'01_16_01.c3d',35,VV,R,E,1,Same,131
754,990,236,1.135758623,0.655555016,688,626,1,269,'01_16_02.c3d',35,VV,R,E,2,Same,62
818,937,119,1.124707434,0.643978178,769,398,245,236,'01_16_03.c3d',35,VV,R,E,3,Same,371
443,847,404,0.996990337,0.660751192,504,1,1,1,'01_16_04.c3d',35,VV,R,E,4,Same,503
756,791,35,1.169729335,0.688259045,494,337,1,1,'01_16_05.c3d',35,VV,R,E,5,Same,157
870,1219,349,0.921267196,0.605182658,959,669,309,312,'01_17_01.c3d',1,VV,R,M,1,Same,290
928,1324,396,0.670060571,0.573387127,736,755,1,323,'01_17_02.c3d',1,VV,R,M,2,Same,19
1060,1259,199,0.890937324,0.566699183,765,725,240,253,'01_17_03.c3d',1,VV,R,M,3,Same,40
601,1295,694,0.763619683,0.498119034,647,418,1,1,'01_17_04.c3d',1,VV,R,M,4,Same,229
1154,1303,149,0.841130015,0.402644546,908,735,263,1,'01_17_05.c3d',1,VV,R,M,5,Same,173
1002,1351,349,0.572614203,0.470799649,938,687,1,237,'01_17_01.c3d',2,VV,R,M,1,Same,251
1053,1442,389,0.598067799,0.50210274,912,705,264,1,'01_17_02.c3d',2,VV,R,M,2,Same,207
1017,1241,224,0.712749044,0.538455675,872,661,295,1,'01_17_03.c3d',2,VV,R,M,3,Same,211
836,1582,746,0.812840988,0.662053096,851,710,1,288,'01_17_04.c3d',2,VV,R,M,4,Same,141
829,1094,265,0.757541403,0.542941355,948,693,239,235,'01_17_05.c3d',2,VV,R,M,5,Same,255
674,882,208,1.057008477,0.756398569,719,432,220,1,'01_17_01.c3d',3,VV,R,M,1,Same,287
1148,1494,346,0.924009022,0.824347185,1169,1143,424,6,'01_17_02.c3d',3,VV,R,M,2,Same,26
740,1359,619,0.576931875,0.478825371,771,487,1,1,'01_17_03.c3d',3,VV,R,M,3,Same,284
619,1337,718,0.973952594,0.762358352,705,418,1,1,'01_17_04.c3d',3,VV,R,M,4,Same,287
763,1130,367,0.843861561,0.538949029,762,339,1,1,'01_17_05.c3d',3,VV,R,M,5,Same,423
872,1102,230,0.900591028,0.54642091,686,606,1,1,'01_17_01.c3d',4,VV,R,M,1,Same,80
841,1118,277,0.883713007,0.618585654,758,757,1,1,'01_17_02.c3d',4,VV,R,M,2,Same,1
766,1031,265,1.124293017,0.724416858,707,635,380,357,'01_17_03.c3d',4,VV,R,M,3,Same,72
774,1484,710,0.902133745,0.630872268,691,676,290,1,'01_17_04.c3d',4,VV,R,M,4,Same,15
747,991,244,0.920592563,0.613721577,664,609,1,273,'01_17_05.c3d',4,VV,R,M,5,Same,55
658,1155,497,1.906238379,1.045200134,635,596,314,306,'01_17_01.c3d',5,VV,R,M,1,Same,39
853,1164,311,1.288717217,0.913471238,820,718,540,444,'01_17_02.c3d',5,VV,R,M,2,Same,102
609,1340,731,1.505578136,1.005568484,437,392,1,92,'01_17_03.c3d',5,VV,R,M,3,Same,45
851,1388,537,1.659844216,1.425062221,717,681,420,406,'01_17_04.c3d',5,VV,R,M,4,Same,36
635,684,49,1.706236557,0.712288891,486,430,195,182,'01_17_05.c3d',5,VV,R,M,5,Same,56
914,1679,765,0.953946376,0.499158082,1458,522,1,32,'01_17_01.c3d',6,VV,R,M,1,Same,936
726,1032,306,0.923918628,0.63790264,762,658,1,1,'01_17_02.c3d',6,VV,R,M,2,Same,104
816,1057,241,0.837485601,0.555343911,786,628,253,1,'01_17_03.c3d',6,VV,R,M,3,Same,158
841,1440,599,0.677769923,0.590609537,1358,640,1,308,'01_17_04.c3d',6,VV,R,M,4,Same,718
824,1247,423,0.90732294,0.597811634,1109,609,1,297,'01_17_05.c3d',6,VV,R,M,5,Same,500
1215,1757,542,0.446379869,0.317502728,1021,1031,1,1,'01_17_01.c3d',7,VV,R,M,1,Same,10
851,1433,582,0.527150488,0.43327986,756,733,1,289,'01_17_02.c3d',7,VV,R,M,2,Same,23
875,2613,1738,0.8114837,0.475199568,779,750,347,1,'01_17_03.c3d',7,VV,R,M,3,Same,29
812,1063,251,0.866533436,0.380236063,736,544,1,208,'01_17_04.c3d',7,VV,R,M,4,Same,192
881,958,77,0.927715815,0.461943475,722,417,255,247,'01_17_05.c3d',7,VV,R,M,5,Same,305
1038,1469,431,0.781906095,0.513691761,870,793,357,1,'01_17_01.c3d',8,VV,R,M,1,Same,77
1005,1258,253,0.769096645,0.455533283,736,678,284,1,'01_17_02.c3d',8,VV,R,M,2,Same,58
970,1450,480,0.771021962,0.446408969,720,624,269,1,'01_17_03.c3d',8,VV,R,M,3,Same,96
660,1014,354,0.975506314,0.794304831,653,609,252,241,'01_17_04.c3d',8,VV,R,M,4,Same,44
1122,1738,616,0.468847708,0.426746192,852,932,355,1,'01_17_05.c3d',8,VV,R,M,5,Same,80
730,1787,1057,0.889488154,0.690404066,1510,481,367,1,'01_17_01.c3d',9,VV,R,M,1,Same,1029
1225,2657,1432,0.690592626,0.515106808,1351,1176,573,6,'01_17_02.c3d',9,VV,R,M,2,Same,175
1188,1722,534,0.863818298,0.435464935,667,458,1,1,'01_17_03.c3d',9,VV,R,M,3,Same,209
718,1676,958,0.713809157,0.533257627,575,661,250,229,'01_17_04.c3d',9,VV,R,M,4,Same,86
943,2278,1335,0.533075152,0.459522529,1655,520,256,23,'01_17_05.c3d',9,VV,R,M,5,Same,1135
1434,2730,1296,1.760588216,1.063437824,1153,1069,762,785,'01_17_01.c3d',10,VV,R,M,1,Same,84
1031,1177,146,1.501566876,0.683674648,834,675,418,1,'01_17_02.c3d',10,VV,R,M,2,Same,159
951,1100,149,1.831806637,1.140977588,721,772,513,1,'01_17_03.c3d',10,VV,R,M,3,Same,51
825,921,96,1.736030257,1.132419391,630,536,410,22,'01_17_04.c3d',10,VV,R,M,4,Same,94
722,1404,682,0.829050114,0.568079438,507,582,224,1,'01_17_05.c3d',10,VV,R,M,5,Same,75
938,1121,183,0.815148924,0.58685967,829,820,1,1,'01_17_01.c3d',11,VV,R,M,1,Same,9
981,1568,587,0.625326274,0.441485177,775,774,1,1,'01_17_02.c3d',11,VV,R,M,2,Same,1
1644,2169,525,0.486037248,0.389513051,1488,1484,1,1,'01_17_03.c3d',11,VV,R,M,3,Same,4
1142,1988,846,0.33060515,0.316369723,1729,1014,296,1,'01_17_04.c3d',11,VV,R,M,4,Same,715
1233,1988,755,0.446232016,0.382646185,1783,975,443,1,'01_17_05.c3d',11,VV,R,M,5,Same,808
921,1189,268,0.761735101,0.528058176,705,582,324,311,'01_17_01.c3d',12,VV,R,M,1,Same,123
882,1136,254,0.729120835,0.394179694,787,595,265,1,'01_17_02.c3d',12,VV,R,M,2,Same,192
829,1040,211,0.824315331,0.463512414,650,540,243,1,'01_17_03.c3d',12,VV,R,M,3,Same,110
793,994,201,0.92082078,0.519259931,724,652,277,1,'01_17_04.c3d',12,VV,R,M,4,Same,72
866,1139,273,0.763359637,0.390056682,593,401,90,1,'01_17_05.c3d',12,VV,R,M,5,Same,192
930,1102,172,0.994090323,0.590858577,844,845,1,1,'01_17_01.c3d',13,VV,R,M,1,Same,1
733,847,114,1.315225873,0.746643049,691,661,222,1,'01_17_02.c3d',13,VV,R,M,2,Same,30
725,858,133,1.078170571,0.640713336,657,525,75,13,'01_17_03.c3d',13,VV,R,M,3,Same,132
943,1077,134,1.137605099,0.603114812,696,616,1,1,'01_17_04.c3d',13,VV,R,M,4,Same,80
656,1370,714,1.125747831,0.789316496,741,605,215,1,'01_17_05.c3d',13,VV,R,M,5,Same,136
830,1065,235,1.441629849,0.980925199,632,506,285,294,'01_17_01.c3d',14,VV,R,M,1,Same,126
549,976,427,1.242425119,0.886167796,488,373,1,1,'01_17_02.c3d',14,VV,R,M,2,Same,115
732,819,87,1.127689827,0.802365584,537,361,21,1,'01_17_03.c3d',14,VV,R,M,3,Same,176
710,755,45,1.439281529,0.662238144,578,568,1,1,'01_17_04.c3d',14,VV,R,M,4,Same,10
767,1118,351,0.954797308,0.746602919,827,628,241,38,'01_17_05.c3d',14,VV,R,M,5,Same,199
767,826,59,1.265452862,0.626748829,629,633,264,255,'01_17_01.c3d',15,VV,R,M,1,Same,4
746,940,194,1.087613306,0.837004077,718,670,1,1,'01_17_02.c3d',15,VV,R,M,2,Same,48
858,1074,216,0.833851347,0.491188854,698,450,261,1,'01_17_03.c3d',15,VV,R,M,3,Same,248
792,1107,315,0.787895626,0.562773367,719,711,226,1,'01_17_04.c3d',15,VV,R,M,4,Same,8
678,1039,361,0.832973313,0.632929018,642,541,1,122,'01_17_05.c3d',15,VV,R,M,5,Same,101
974,1087,113,0.979395745,0.503084829,728,720,306,291,'01_17_01.c3d',16,VV,R,M,1,Same,8
752,1048,296,1.35168846,0.869360347,619,479,196,36,'01_17_02.c3d',16,VV,R,M,2,Same,140
833,1180,347,0.866695033,0.736869967,847,688,1,1,'01_17_03.c3d',16,VV,R,M,3,Same,159
893,1099,206,1.132504079,0.514000301,657,412,1,1,'01_17_04.c3d',16,VV,R,M,4,Same,245
1087,1248,161,0.662325325,0.357404403,888,577,211,1,'01_17_05.c3d',16,VV,R,M,5,Same,311
1051,1322,271,0.769889619,0.548791273,716,709,314,292,'01_17_01.c3d',17,VV,R,M,1,Same,7
654,1141,487,2.338867892,0.926654843,563,559,315,1,'01_17_02.c3d',17,VV,R,M,2,Same,4
526,637,111,1.734478732,1.0600988,493,337,244,248,'01_17_03.c3d',17,VV,R,M,3,Same,156
495,650,155,1.531636488,1.011976239,481,347,235,1,'01_17_04.c3d',17,VV,R,M,4,Same,134
569,618,49,1.983360253,1.100089916,496,485,260,257,'01_17_05.c3d',17,VV,R,M,5,Same,11
1139,1680,541,0.812196796,0.639109549,743,706,1,1,'01_17_01.c3d',18,VV,R,M,1,Same,37
769,1704,935,1.14203854,0.920670921,709,705,1,1,'01_17_02.c3d',18,VV,R,M,2,Same,4
650,1491,841,1.227315166,0.970056528,486,432,1,1,'01_17_03.c3d',18,VV,R,M,3,Same,54
886,984,98,1.224354624,0.651758902,634,603,1,307,'01_17_04.c3d',18,VV,R,M,4,Same,31
776,883,107,1.141835992,0.81428443,674,589,272,1,'01_17_05.c3d',18,VV,R,M,5,Same,85
739,1165,426,0.888952678,0.737351956,741,676,337,1,'01_17_01.c3d',19,VV,R,M,1,Same,65
1019,1162,143,0.929575556,0.680146522,776,766,1,236,'01_17_02.c3d',19,VV,R,M,2,Same,10
749,1220,471,0.719972426,0.622502273,608,562,249,207,'01_17_03.c3d',19,VV,R,M,3,Same,46
720,1253,533,1.081475842,0.664012478,614,584,233,1,'01_17_04.c3d',19,VV,R,M,4,Same,30
780,1136,356,0.850818402,0.643300833,654,613,244,237,'01_17_05.c3d',19,VV,R,M,5,Same,41
776,1186,410,0.885707332,0.667160285,720,613,1,256,'01_17_01.c3d',20,VV,R,M,1,Same,107
767,1165,398,0.863930104,0.703361389,743,577,310,277,'01_17_02.c3d',20,VV,R,M,2,Same,166
810,1127,317,0.955436773,0.758241788,784,651,386,365,'01_17_03.c3d',20,VV,R,M,3,Same,133
929,1204,275,0.751042014,0.543149677,641,649,1,277,'01_17_04.c3d',20,VV,R,M,4,Same,8
808,1526,718,0.602445931,0.578801157,739,606,279,281,'01_17_05.c3d',20,VV,R,M,5,Same,133
1044,1530,486,0.50970361,0.453402106,1215,730,1,1,'01_17_01.c3d',21,VV,R,M,1,Same,485
1118,1395,277,0.720805191,0.47996862,970,828,410,1,'01_17_02.c3d',21,VV,R,M,2,Same,142
933,1235,302,0.632205607,0.406577362,911,632,270,1,'01_17_03.c3d',21,VV,R,M,3,Same,279
956,1464,508,0.576495354,0.496389544,683,666,1,294,'01_17_04.c3d',21,VV,R,M,4,Same,17
909,1463,554,0.676524693,0.540960888,750,762,382,1,'01_17_05.c3d',21,VV,R,M,5,Same,12
1520,1921,401,0.482001408,0.387788081,1011,1266,1,521,'01_17_01.c3d',22,VV,R,M,1,Same,255
855,1335,480,0.854134726,0.945997211,983,674,394,1,'01_17_02.c3d',22,VV,R,M,2,Same,309
889,1457,568,0.62543038,0.735111111,1162,737,332,340,'01_17_03.c3d',22,VV,R,M,3,Same,425
930,1336,406,0.713333975,0.605400028,991,656,316,308,'01_17_04.c3d',22,VV,R,M,4,Same,335
1034,1729,695,0.679116103,0.746805747,1239,821,1,358,'01_17_05.c3d',22,VV,R,M,5,Same,418
1094,2422,1328,0.487667536,0.461689944,1510,928,303,289,'01_17_01.c3d',23,VV,R,M,1,Same,582
911,1403,492,0.524144874,0.464234713,1150,732,194,162,'01_17_02.c3d',23,VV,R,M,2,Same,418
2660,3435,775,0.444655286,0.339924438,1485,1817,514,136,'01_17_03.c3d',23,VV,R,M,3,Same,332
1472,2147,675,0.449810745,0.308983867,1043,840,269,1,'01_17_04.c3d',23,VV,R,M,4,Same,203
1259,1821,562,0.447862026,0.429973297,1248,929,45,1,'01_17_05.c3d',23,VV,R,M,5,Same,319
808,944,136,1.056901261,0.5554809,729,648,304,1,'01_17_01.c3d',24,VV,R,M,1,Same,81
806,983,177,1.002281395,0.567279306,700,491,295,1,'01_17_02.c3d',24,VV,R,M,2,Same,209
864,1001,137,1.056148774,0.523754661,739,682,286,255,'01_17_03.c3d',24,VV,R,M,3,Same,57
766,945,179,1.012821919,0.516522213,685,592,203,1,'01_17_04.c3d',24,VV,R,M,4,Same,93
834,1176,342,0.717925029,0.527153647,866,683,255,1,'01_17_05.c3d',24,VV,R,M,5,Same,183
653,1253,600,1.066005748,0.672423179,662,561,220,196,'01_17_01.c3d',25,VV,R,M,1,Same,101
755,1097,342,0.934249139,0.533280051,625,491,222,219,'01_17_02.c3d',25,VV,R,M,2,Same,134
675,1178,503,0.985370661,0.634862645,645,480,264,1,'01_17_03.c3d',25,VV,R,M,3,Same,165
654,1681,1027,0.92223325,0.597264053,700,567,220,1,'01_17_04.c3d',25,VV,R,M,4,Same,133
807,1512,705,0.871355002,0.571319731,761,657,228,1,'01_17_05.c3d',25,VV,R,M,5,Same,104
1176,2418,1242,0.855284478,0.420292741,880,518,330,1,'01_17_01.c3d',26,VV,R,M,1,Same,362
1175,1521,346,0.539969118,0.354975493,1083,851,421,406,'01_17_02.c3d',26,VV,R,M,2,Same,232
901,2264,1363,0.540760584,0.458128059,1038,705,305,35,'01_17_03.c3d',26,VV,R,M,3,Same,333
1187,1206,19,0.693000312,0.29506411,896,754,298,256,'01_17_04.c3d',26,VV,R,M,4,Same,142
1514,4542,3028,0.599591535,0.224347605,1833,1233,659,208,'01_17_05.c3d',26,VV,R,M,5,Same,600
1165,2008,843,0.849046366,0.439016677,836,865,415,38,'01_17_01.c3d',27,VV,R,M,1,Same,29
1002,1692,690,0.839235282,0.621455022,917,778,408,1,'01_17_02.c3d',27,VV,R,M,2,Same,139
1426,1794,368,0.661523238,0.392245087,1036,809,1,1,'01_17_03.c3d',27,VV,R,M,3,Same,227
1453,1802,349,0.761812844,0.546913241,1372,1040,1,1,'01_17_04.c3d',27,VV,R,M,4,Same,332
1219,1659,440,0.754574084,0.550016768,1149,962,93,532,'01_17_05.c3d',27,VV,R,M,5,Same,187
891,1741,850,0.676207931,0.732362234,1405,720,446,1,'01_17_01.c3d',28,VV,R,M,1,Same,685
1294,1625,331,0.772304003,0.449038963,1300,1089,1,1,'01_17_02.c3d',28,VV,R,M,2,Same,211
965,2030,1065,0.764635129,0.585242794,1761,873,876,373,'01_17_03.c3d',28,VV,R,M,3,Same,888
1029,1333,304,0.770678593,0.477610104,1054,838,1,311,'01_17_04.c3d',28,VV,R,M,4,Same,216
944,1184,240,0.903027217,0.526593185,942,810,290,282,'01_17_05.c3d',28,VV,R,M,5,Same,132
792,1151,359,1.013089406,0.657610591,655,511,1,1,'01_17_01.c3d',29,VV,R,M,1,Same,144
831,960,129,0.940625714,0.5632137,720,656,272,238,'01_17_02.c3d',29,VV,R,M,2,Same,64
873,1257,384,0.717814142,0.640167262,874,719,335,327,'01_17_03.c3d',29,VV,R,M,3,Same,155
775,968,193,0.841136989,0.533974706,649,517,1,32,'01_17_04.c3d',29,VV,R,M,4,Same,132
1032,1158,126,0.679425264,0.456249311,691,547,209,1,'01_17_05.c3d',29,VV,R,M,5,Same,144
671,975,304,0.913196406,0.679064133,643,461,1,1,'01_17_01.c3d',30,VV,R,M,1,Same,182
815,1203,388,0.924814832,0.525255396,747,632,1,1,'01_17_02.c3d',30,VV,R,M,2,Same,115
1033,1222,189,0.677043333,0.397078566,855,756,1,1,'01_17_03.c3d',30,VV,R,M,3,Same,99
885,1164,279,0.79706581,0.487642431,973,715,1,1,'01_17_04.c3d',30,VV,R,M,4,Same,258
721,1451,730,0.793942365,0.469450558,787,633,94,1,'01_17_05.c3d',30,VV,R,M,5,Same,154
760,1001,241,1.321593018,0.891930025,646,545,284,271,'01_17_01.c3d',31,VV,R,M,1,Same,101
853,1236,383,1.110342924,0.654517173,715,529,298,258,'01_17_02.c3d',31,VV,R,M,2,Same,186
788,957,169,1.574536674,0.80238057,688,649,368,52,'01_17_03.c3d',31,VV,R,M,3,Same,39
713,1773,1060,1.511041712,0.990448768,646,629,303,284,'01_17_04.c3d',31,VV,R,M,4,Same,17
677,910,233,1.577905787,0.943822802,623,598,308,296,'01_17_05.c3d',31,VV,R,M,5,Same,25
949,1463,514,1.285122876,0.366873431,742,675,349,302,'01_17_01.c3d',32,VV,R,M,1,Same,67
793,1172,379,0.830561929,0.633621404,698,674,1,1,'01_17_02.c3d',32,VV,R,M,2,Same,24
1101,1229,128,1.132932694,0.31415024,963,887,409,1,'01_17_03.c3d',32,VV,R,M,3,Same,76
885,1193,308,0.785166081,0.549784756,738,722,278,1,'01_17_04.c3d',32,VV,R,M,4,Same,16
944,1198,254,0.873800313,0.525215258,765,764,317,279,'01_17_05.c3d',32,VV,R,M,5,Same,1
868,1781,913,0.990869612,0.647598957,1047,714,386,1,'01_17_01.c3d',33,VV,R,M,1,Same,333
944,2329,1385,1.058041615,0.654216535,970,902,1,321,'01_17_02.c3d',33,VV,R,M,2,Same,68
1047,1408,361,0.877154163,0.543637869,1125,858,454,430,'01_17_03.c3d',33,VV,R,M,3,Same,267
916,1806,890,1.006038566,0.673543101,851,856,379,384,'01_17_04.c3d',33,VV,R,M,4,Same,5
889,1347,458,0.836725347,0.685433566,822,763,360,1,'01_17_05.c3d',33,VV,R,M,5,Same,59
1307,1402,95,0.930136717,0.360303923,1066,775,1,31,'01_17_01.c3d',34,VV,R,M,1,Same,291
750,866,116,1.307535367,0.608839903,663,644,325,1,'01_17_02.c3d',34,VV,R,M,2,Same,19
648,1098,450,0.861637341,0.63505143,604,570,1,250,'01_17_03.c3d',34,VV,R,M,3,Same,34
938,2521,1583,0.580478308,0.475509367,970,834,303,284,'01_17_04.c3d',34,VV,R,M,4,Same,136
920,927,7,0.78028555,0.768582632,710,396,82,1,'01_17_05.c3d',34,VV,R,M,5,Same,314
669,1195,526,0.912906308,0.619557467,707,603,145,1,'01_17_01.c3d',35,VV,R,M,1,Same,104
694,1150,456,0.975355783,0.732515864,770,593,1,1,'01_17_02.c3d',35,VV,R,M,2,Same,177
912,1071,159,0.909280733,0.486774981,730,636,102,1,'01_17_03.c3d',35,VV,R,M,3,Same,94
756,1015,259,1.138092665,0.713432748,710,567,1,221,'01_17_04.c3d',35,VV,R,M,4,Same,143
906,1097,191,0.989999833,0.455763308,586,373,1,35,'01_17_05.c3d',35,VV,R,M,5,Same,213
917,1724,807,0.593573703,0.473890965,828,788,231,1,'01_18_01.c3d',1,VV,R,H,1,Same,40
1251,2861,1610,0.844710032,0.670148839,876,832,175,168,'01_18_02.c3d',1,VV,R,H,2,Same,44
1003,1211,208,0.751935208,0.404030281,755,703,1,222,'01_18_03.c3d',1,VV,R,H,3,Same,52
1278,1338,60,0.886920811,0.368412287,1071,815,1,64,'01_18_04.c3d',1,VV,R,H,4,Same,256
998,1162,164,0.920663694,0.52047279,816,850,290,287,'01_18_05.c3d',1,VV,R,H,5,Same,34
1688,1912,224,0.577411453,0.322553616,1760,1,1,1,'01_18_01.c3d',2,VV,R,H,1,Same,1759
904,1396,492,0.680988236,0.626462255,1085,694,299,276,'01_18_02.c3d',2,VV,R,H,2,Same,391
1100,2423,1323,0.569469271,0.559862489,1012,902,1,150,'01_18_03.c3d',2,VV,R,H,3,Same,110
1033,1464,431,0.621110378,0.420529634,1257,848,1,1,'01_18_04.c3d',2,VV,R,H,4,Same,409
914,1280,366,0.656719063,0.481892949,1044,646,258,241,'01_18_05.c3d',2,VV,R,H,5,Same,398
855,1439,584,0.681746568,0.641488883,817,761,252,1,'01_18_01.c3d',3,VV,R,H,1,Same,56
655,924,269,1.043689659,0.883832962,533,531,1,1,'01_18_02.c3d',3,VV,R,H,2,Same,2
817,998,181,0.853571731,0.566713569,799,559,1,1,'01_18_03.c3d',3,VV,R,H,3,Same,240
783,872,89,1.134257648,0.593536203,546,779,251,1,'01_18_04.c3d',3,VV,R,H,4,Same,233
823,992,169,1.033694924,0.589100601,645,554,246,1,'01_18_05.c3d',3,VV,R,H,5,Same,91
767,1223,456,0.997221188,0.663556391,791,659,292,273,'01_18_01.c3d',4,VV,R,H,1,Same,132
817,1304,487,0.924896061,0.663136829,751,714,372,358,'01_18_02.c3d',4,VV,R,H,2,Same,37
606,1167,561,0.930696318,0.529817769,581,562,76,1,'01_18_03.c3d',4,VV,R,H,3,Same,19
869,1244,375,0.751404788,0.516054792,688,815,284,1,'01_18_04.c3d',4,VV,R,H,4,Same,127
1090,1297,207,0.717747029,0.431890818,785,740,299,1,'01_18_05.c3d',4,VV,R,H,5,Same,45
609,1138,529,1.848347215,1.04062496,611,554,1,305,'01_18_01.c3d',5,VV,R,H,1,Same,57
930,1519,589,1.056360641,0.880744358,587,528,260,237,'01_18_02.c3d',5,VV,R,H,2,Same,59
617,1412,795,1.941998154,1.435136868,588,576,338,289,'01_18_03.c3d',5,VV,R,H,3,Same,12
632,708,76,1.740853522,0.880152108,543,495,289,267,'01_18_04.c3d',5,VV,R,H,4,Same,48
628,924,296,1.354921668,1.343576457,621,582,342,322,'01_18_05.c3d',5,VV,R,H,5,Same,39
795,1335,540,0.674454331,0.651453703,843,633,1,1,'01_18_01.c3d',6,VV,R,H,1,Same,210
874,1801,927,0.83193997,0.572278275,1394,598,1,278,'01_18_02.c3d',6,VV,R,H,2,Same,796
873,1240,367,0.822020349,0.547085202,1144,691,297,1,'01_18_03.c3d',6,VV,R,H,3,Same,453
917,1449,532,0.752510567,0.584811879,1252,631,255,302,'01_18_04.c3d',6,VV,R,H,4,Same,621
910,1336,426,0.749018919,0.483944189,1168,648,1,1,'01_18_05.c3d',6,VV,R,H,5,Same,520
995,1244,249,0.648036151,0.349124071,869,622,1,29,'01_18_01.c3d',7,VV,R,H,1,Same,247
927,1082,155,0.690529547,0.391955973,780,600,229,1,'01_18_02.c3d',7,VV,R,H,2,Same,180
499,797,298,0.78593111,0.392241448,1,371,1,1,'01_18_03.c3d',7,VV,R,H,3,Same,370
704,1155,451,0.884822317,0.39890441,959,581,244,1,'01_18_04.c3d',7,VV,R,H,4,Same,378
1007,1008,1,0.870604439,0.337964118,770,676,282,1,'01_18_05.c3d',7,VV,R,H,5,Same,94
937,1677,740,0.670542035,0.51585333,1358,801,295,305,'01_18_01.c3d',8,VV,R,H,1,Same,557
1023,1718,695,0.467804237,0.415122054,881,881,279,274,'01_18_02.c3d',8,VV,R,H,2,Same,0
1043,1444,401,0.630097201,0.473710497,771,736,337,1,'01_18_03.c3d',8,VV,R,H,3,Same,35
1155,1812,657,0.431460489,0.325295854,823,845,200,144,'01_18_04.c3d',8,VV,R,H,4,Same,22
907,1366,459,0.587377484,0.438490861,696,721,205,1,'01_18_05.c3d',8,VV,R,H,5,Same,25
741,1753,1012,0.696267921,0.661019346,1508,565,1,241,'01_18_01.c3d',9,VV,R,H,1,Same,943
666,1518,852,0.61827929,0.670130789,627,550,1,243,'01_18_02.c3d',9,VV,R,H,2,Same,77
778,1305,527,0.672326772,0.572168988,674,591,287,257,'01_18_03.c3d',9,VV,R,H,3,Same,83
917,1527,610,0.536986914,0.450576475,700,655,1,1,'01_18_04.c3d',9,VV,R,H,4,Same,45
874,1821,947,0.586327435,0.5393201,749,670,327,1,'01_18_05.c3d',9,VV,R,H,5,Same,79
841,901,60,1.395960216,0.840442574,707,608,351,1,'01_18_01.c3d',10,VV,R,H,1,Same,99
791,1186,395,0.956068645,0.933731812,638,580,1,1,'01_18_02.c3d',10,VV,R,H,2,Same,58
703,1065,362,0.956435399,0.837840573,806,552,260,255,'01_18_03.c3d',10,VV,R,H,3,Same,254
799,1300,501,0.83905035,0.831680655,743,626,1,322,'01_18_04.c3d',10,VV,R,H,4,Same,117
712,1146,434,1.214663864,0.968920369,782,612,373,364,'01_18_05.c3d',10,VV,R,H,5,Same,170
1340,2099,759,0.365595205,0.25639007,1850,1026,289,318,'01_18_01.c3d',11,VV,R,H,1,Same,824
1231,3669,2438,0.449203312,0.337883787,1671,1233,1,32,'01_18_02.c3d',11,VV,R,H,2,Same,438
1720,2378,658,0.363803455,0.209990795,2061,1285,251,1,'01_18_03.c3d',11,VV,R,H,3,Same,776
1483,2065,582,0.371957937,0.258224431,1434,1233,1,19,'01_18_04.c3d',11,VV,R,H,4,Same,201
1305,1847,542,0.442013076,0.296062453,1325,969,1,408,'01_18_05.c3d',11,VV,R,H,5,Same,356
836,1187,351,0.723424887,0.468192886,599,686,1,1,'01_18_01.c3d',12,VV,R,H,1,Same,87
825,1159,334,0.69273426,0.449643988,766,533,1,142,'01_18_02.c3d',12,VV,R,H,2,Same,233
976,1373,397,0.559855708,0.370969053,730,746,279,268,'01_18_03.c3d',12,VV,R,H,3,Same,16
913,1310,397,0.636867213,0.424616748,648,790,1,282,'01_18_04.c3d',12,VV,R,H,4,Same,142
1006,1299,293,0.674438639,0.400581759,737,744,310,293,'01_18_05.c3d',12,VV,R,H,5,Same,7
869,1085,216,0.985599022,0.603062556,878,660,313,1,'01_18_01.c3d',13,VV,R,H,1,Same,218
801,1063,262,0.940599749,0.588197927,670,550,250,1,'01_18_02.c3d',13,VV,R,H,2,Same,120
823,1004,181,1.005105719,0.559399618,761,666,1,1,'01_18_03.c3d',13,VV,R,H,3,Same,95
830,1052,222,1.012221169,0.516529817,699,726,302,1,'01_18_04.c3d',13,VV,R,H,4,Same,27
975,1139,164,1.007207768,0.541252643,835,725,313,250,'01_18_05.c3d',13,VV,R,H,5,Same,110
689,713,24,1.369251509,1.003954778,468,356,1,172,'01_18_01.c3d',14,VV,R,H,1,Same,112
846,854,8,1.181747096,0.831020688,638,481,238,1,'01_18_02.c3d',14,VV,R,H,2,Same,157
545,764,219,1.409469788,1.003498198,496,474,213,216,'01_18_03.c3d',14,VV,R,H,3,Same,22
667,797,130,1.233834173,0.872351252,655,461,1,187,'01_18_04.c3d',14,VV,R,H,4,Same,194
550,642,92,1.353252764,0.798504106,433,332,1,108,'01_18_05.c3d',14,VV,R,H,5,Same,101
1375,1855,480,0.88844461,0.446501337,1027,730,1,1,'01_18_01.c3d',15,VV,R,H,1,Same,297
1221,1278,57,0.915836659,0.469289096,1043,928,1,21,'01_18_02.c3d',15,VV,R,H,2,Same,115
1029,1610,581,1.026836741,0.555463396,828,545,1,1,'01_18_03.c3d',15,VV,R,H,3,Same,283
834,1072,238,0.812321149,0.5596694,692,681,200,193,'01_18_04.c3d',15,VV,R,H,4,Same,11
679,1104,425,0.736136837,0.600910141,547,552,1,1,'01_18_05.c3d',15,VV,R,H,5,Same,5
2056,3263,1207,0.757580787,0.376867246,2614,1945,1737,1095,'01_18_01.c3d',16,VV,R,H,1,Same,669
1080,1254,174,0.763382996,0.418870525,779,761,278,1,'01_18_02.c3d',16,VV,R,H,2,Same,18
881,942,61,1.196691101,0.639248964,664,722,318,309,'01_18_03.c3d',16,VV,R,H,3,Same,58
920,1912,992,1.138492129,0.770745689,707,608,266,22,'01_18_04.c3d',16,VV,R,H,4,Same,99
806,1148,342,0.951486663,0.682831876,684,628,273,245,'01_18_05.c3d',16,VV,R,H,5,Same,56
567,797,230,1.483166809,1.044505084,487,503,251,255,'01_18_01.c3d',17,VV,R,H,1,Same,16
591,712,121,1.607306914,0.800092158,521,493,253,250,'01_18_02.c3d',17,VV,R,H,2,Same,28
459,773,314,1.642702575,1.340444952,424,349,251,1,'01_18_03.c3d',17,VV,R,H,3,Same,75
593,849,256,1.506714591,0.763815763,502,471,262,260,'01_18_04.c3d',17,VV,R,H,4,Same,31
602,603,1,1.93475999,1.047709532,489,389,221,1,'01_18_05.c3d',17,VV,R,H,5,Same,100
1130,1860,730,0.932103539,0.749662106,766,745,1,1,'01_18_01.c3d',18,VV,R,H,1,Same,21
1022,1635,613,1.069429228,0.706564432,764,729,5,1,'01_18_02.c3d',18,VV,R,H,2,Same,35
559,1459,900,1.19483058,0.902450823,537,511,1,1,'01_18_03.c3d',18,VV,R,H,3,Same,26
1035,1986,951,1.025980298,0.615993481,815,839,1,1,'01_18_04.c3d',18,VV,R,H,4,Same,24
719,2357,1638,0.870733057,0.606428349,681,628,1,1,'01_18_05.c3d',18,VV,R,H,5,Same,53
878,1439,561,0.523167376,0.603754312,1206,664,1,268,'01_18_01.c3d',19,VV,R,H,1,Same,542
863,1524,661,0.699463059,0.627721027,1321,658,318,1,'01_18_02.c3d',19,VV,R,H,2,Same,663
874,1165,291,0.781116586,0.557285165,837,820,1,1,'01_18_03.c3d',19,VV,R,H,3,Same,17
715,942,227,0.932998718,0.715888676,619,614,1,1,'01_18_04.c3d',19,VV,R,H,4,Same,5
835,1175,340,0.745894599,0.669919785,636,610,273,1,'01_18_05.c3d',19,VV,R,H,5,Same,26
847,1190,343,0.753374736,0.572516168,891,706,1,261,'01_18_01.c3d',20,VV,R,H,1,Same,185
840,1124,284,0.871131792,0.533383067,706,587,256,1,'01_18_02.c3d',20,VV,R,H,2,Same,119
810,1450,640,0.825151546,0.678391873,650,662,290,1,'01_18_03.c3d',20,VV,R,H,3,Same,12
951,1488,537,0.663971877,0.462286564,838,619,319,1,'01_18_04.c3d',20,VV,R,H,4,Same,219
904,1287,383,0.655287919,0.507641418,916,580,1,251,'01_18_05.c3d',20,VV,R,H,5,Same,336
923,1510,587,0.673846073,0.53342453,1000,807,313,280,'01_18_01.c3d',21,VV,R,H,1,Same,193
863,1677,814,0.926158211,0.649557679,843,801,1,296,'01_18_02.c3d',21,VV,R,H,2,Same,42
862,1149,287,0.700390808,0.483118497,789,666,260,1,'01_18_03.c3d',21,VV,R,H,3,Same,123
1124,1292,168,0.624524702,0.36506059,1041,735,302,1,'01_18_04.c3d',21,VV,R,H,4,Same,306
894,1430,536,0.720365679,0.489195162,738,646,258,249,'01_18_05.c3d',21,VV,R,H,5,Same,92
855,1232,377,0.8142329,0.924097545,861,643,311,1,'01_18_01.c3d',22,VV,R,H,1,Same,218
848,1396,548,0.670570902,0.860808075,1217,716,324,317,'01_18_02.c3d',22,VV,R,H,2,Same,501
879,1364,485,0.653655251,0.749469939,1019,747,263,1,'01_18_03.c3d',22,VV,R,H,3,Same,272
824,1344,520,0.691517852,0.737238088,792,665,268,268,'01_18_04.c3d',22,VV,R,H,4,Same,127
1092,1512,420,0.670173917,0.647477774,1084,817,339,360,'01_18_05.c3d',22,VV,R,H,5,Same,267
1065,2031,966,0.442765407,0.45489201,1077,834,267,258,'01_18_01.c3d',23,VV,R,H,1,Same,243
2078,2118,40,0.418796075,0.347787788,1340,1131,469,436,'01_18_02.c3d',23,VV,R,H,2,Same,209
1230,2252,1022,0.313896999,0.3717573,1811,962,252,284,'01_18_03.c3d',23,VV,R,H,3,Same,849
1690,1772,82,0.494633605,0.24525497,1142,1485,289,203,'01_18_04.c3d',23,VV,R,H,4,Same,343
1681,2641,960,0.282041753,0.292139074,2103,1416,1,322,'01_18_05.c3d',23,VV,R,H,5,Same,687
948,1116,168,0.905034288,0.45297245,932,690,285,288,'01_18_01.c3d',24,VV,R,H,1,Same,242
831,986,155,0.970150645,0.507283102,697,665,228,1,'01_18_02.c3d',24,VV,R,H,2,Same,32
945,984,39,1.02692679,0.388242272,732,706,169,103,'01_18_03.c3d',24,VV,R,H,3,Same,26
774,1025,251,0.772751124,0.455884787,735,491,104,39,'01_18_04.c3d',24,VV,R,H,4,Same,244
693,1059,366,0.674957485,0.517764721,584,456,124,101,'01_18_05.c3d',24,VV,R,H,5,Same,128
1183,1664,481,0.829398942,0.588356572,643,621,509,1,'01_18_01.c3d',25,VV,R,H,1,Same,22
1090,2128,1038,0.645364201,0.428663981,928,929,341,1,'01_18_02.c3d',25,VV,R,H,2,Same,1
857,1371,514,0.978230231,0.550881293,730,741,277,245,'01_18_03.c3d',25,VV,R,H,3,Same,11
788,1139,351,0.889828526,0.502112766,753,660,266,277,'01_18_04.c3d',25,VV,R,H,4,Same,93
870,1227,357,0.892666359,0.538323624,783,732,332,309,'01_18_05.c3d',25,VV,R,H,5,Same,51
1263,1484,221,0.601489572,0.378186855,1028,734,284,1,'01_18_01.c3d',26,VV,R,H,1,Same,294
942,2571,1629,0.524983711,0.370055184,1035,791,1,291,'01_18_02.c3d',26,VV,R,H,2,Same,244
755,2192,1437,0.749034595,0.471264921,830,639,289,1,'01_18_03.c3d',26,VV,R,H,3,Same,191
1222,1299,77,0.565487533,0.232787438,1000,703,109,1,'01_18_04.c3d',26,VV,R,H,4,Same,297
1208,1496,288,0.528332045,0.29991629,1015,936,363,1,'01_18_05.c3d',26,VV,R,H,5,Same,79
1266,1408,142,0.768943645,0.559069336,1030,954,419,389,'01_18_01.c3d',27,VV,R,H,1,Same,76
1652,1686,34,0.802068373,0.429994879,1289,895,1,1,'01_18_02.c3d',27,VV,R,H,2,Same,394
1092,1634,542,0.723938766,0.679902265,1143,871,1,1,'01_18_03.c3d',27,VV,R,H,3,Same,272
1378,1707,329,0.580154299,0.363089619,904,980,386,356,'01_18_04.c3d',27,VV,R,H,4,Same,76
1129,1773,644,0.574199497,0.527883345,1044,863,348,1,'01_18_05.c3d',27,VV,R,H,5,Same,181
1354,2395,1041,0.527541823,0.370908326,2088,917,546,1,'01_18_01.c3d',28,VV,R,H,1,Same,1171
893,1634,741,0.690136029,0.530069353,1267,650,297,284,'01_18_02.c3d',28,VV,R,H,2,Same,617
1226,1617,391,0.887678481,0.508547599,980,957,324,342,'01_18_03.c3d',28,VV,R,H,3,Same,23
1434,1520,86,0.774641457,0.415726394,1238,1166,1,1,'01_18_04.c3d',28,VV,R,H,4,Same,72
967,1243,276,0.825631778,0.511643511,946,848,1,291,'01_18_05.c3d',28,VV,R,H,5,Same,98
1019,1084,65,1.060267635,0.518567847,819,729,382,379,'01_18_01.c3d',29,VV,R,H,1,Same,90
769,1033,264,1.008346111,0.667135846,763,674,322,1,'01_18_02.c3d',29,VV,R,H,2,Same,89
648,1350,702,0.960163425,0.67287352,665,545,1,1,'01_18_03.c3d',29,VV,R,H,3,Same,120
895,1162,267,0.700077558,0.476057466,816,616,233,1,'01_18_04.c3d',29,VV,R,H,4,Same,200
915,1131,216,0.777631877,0.45288829,818,622,255,1,'01_18_05.c3d',29,VV,R,H,5,Same,196
711,1005,294,0.869384465,0.518400948,780,647,1,1,'01_18_01.c3d',30,VV,R,H,1,Same,133
773,1280,507,0.638876391,0.429796316,875,531,207,1,'01_18_02.c3d',30,VV,R,H,2,Same,344
826,1300,474,0.642897792,0.419020693,1004,680,1,119,'01_18_03.c3d',30,VV,R,H,3,Same,324
972,1093,121,0.649143495,0.34861883,825,438,40,1,'01_18_04.c3d',30,VV,R,H,4,Same,387
977,1373,396,0.665637849,0.35096384,813,716,1,239,'01_18_05.c3d',30,VV,R,H,5,Same,97
718,1012,294,1.487269611,0.812765922,693,608,316,271,'01_18_01.c3d',31,VV,R,H,1,Same,85
813,971,158,1.438577118,0.692349842,779,543,307,296,'01_18_02.c3d',31,VV,R,H,2,Same,236
809,1007,198,1.237978378,0.711546691,661,634,245,246,'01_18_03.c3d',31,VV,R,H,3,Same,27
792,1080,288,1.245583754,0.783227873,688,589,1,328,'01_18_04.c3d',31,VV,R,H,4,Same,99
775,948,173,1.353855293,0.654290756,681,579,275,254,'01_18_05.c3d',31,VV,R,H,5,Same,102
1015,1045,30,0.88132737,0.48190582,672,632,284,1,'01_18_01.c3d',32,VV,R,H,1,Same,40
1077,1474,397,0.676055966,0.393170714,798,763,289,261,'01_18_02.c3d',32,VV,R,H,2,Same,35
1099,1428,329,0.670202743,0.354579396,908,832,281,275,'01_18_03.c3d',32,VV,R,H,3,Same,76
1016,1396,380,0.652732761,0.437631208,983,788,327,284,'01_18_04.c3d',32,VV,R,H,4,Same,195
964,1363,399,0.758957783,0.486388075,821,809,290,257,'01_18_05.c3d',32,VV,R,H,5,Same,12
1123,1818,695,0.851485536,0.532487255,1315,1004,459,1,'01_18_01.c3d',33,VV,R,H,1,Same,311
1010,1410,400,0.752191804,0.514375715,1195,908,380,315,'01_18_02.c3d',33,VV,R,H,2,Same,287
1027,1383,356,0.791497867,0.535749559,1177,892,418,383,'01_18_03.c3d',33,VV,R,H,3,Same,285
1115,1463,348,0.761487922,0.488991039,1074,951,380,1,'01_18_04.c3d',33,VV,R,H,4,Same,123
1092,1349,257,0.809871669,0.540844946,1064,930,424,1,'01_18_05.c3d',33,VV,R,H,5,Same,134
918,1935,1017,0.742680482,0.691152383,818,829,345,349,'01_18_01.c3d',34,VV,R,H,1,Same,11
880,1165,285,0.943474653,0.545631687,835,766,1,318,'01_18_02.c3d',34,VV,R,H,2,Same,69
839,1249,410,0.734546568,0.550702638,688,658,1,259,'01_18_03.c3d',34,VV,R,H,3,Same,30
650,1406,756,1.008781835,0.621949158,617,597,237,1,'01_18_04.c3d',34,VV,R,H,4,Same,20
811,1562,751,0.577923365,0.565519927,910,677,1,1,'01_18_05.c3d',34,VV,R,H,5,Same,233
1022,1267,245,0.905707236,0.525629315,800,752,348,1,'01_18_01.c3d',35,VV,R,H,1,Same,48
954,1341,387,0.822726123,0.552101469,930,776,1,1,'01_18_02.c3d',35,VV,R,H,2,Same,154
743,1063,320,0.921145298,0.604965089,625,602,222,211,'01_18_03.c3d',35,VV,R,H,3,Same,23
763,1337,574,0.897138709,0.598148582,572,572,216,1,'01_18_04.c3d',35,VV,R,H,4,Same,0
842,1214,372,0.979422749,0.578576524,706,642,1,1,'01_18_05.c3d',35,VV,R,H,5,Same,64
1236,1985,749,1.252865885,0.913207078,562,900,1,1,'01_19_01.c3d',1,EV,B,E,1,diff,338
1054,2810,1756,1.210312256,0.805200472,613,1454,295,307,'01_19_02.c3d',1,EV,B,E,2,diff,841
1269,1278,9,1.067111151,1.096723486,767,1156,1,475,'01_19_03.c3d',1,EV,B,E,3,diff,389
946,2003,1057,0.984744219,1.268748858,505,780,137,250,'01_19_04.c3d',1,EV,B,E,4,diff,275
1449,1624,175,1.000493778,0.730385437,547,738,274,1,'01_19_05.c3d',1,EV,B,E,5,diff,191
1850,1951,101,1.276629704,1.028072442,1192,1569,1,410,'01_19_01.c3d',2,EV,B,E,1,diff,377
1394,1940,546,0.837331251,0.728941384,586,1198,134,252,'01_19_02.c3d',2,EV,B,E,2,diff,612
1153,1451,298,1.173064522,1.1994501,529,912,273,282,'01_19_03.c3d',2,EV,B,E,3,diff,383
1771,2011,240,0.988927165,0.88806438,521,1051,265,1,'01_19_04.c3d',2,EV,B,E,4,diff,530
1228,1526,298,0.758078112,0.941504912,519,794,253,1,'01_19_05.c3d',2,EV,B,E,5,diff,275
781,834,53,2.02655895,1.579975025,427,680,12,262,'01_19_01.c3d',3,EV,B,E,1,diff,253
778,892,114,1.671215424,1.548456041,544,782,1,373,'01_19_02.c3d',3,EV,B,E,2,diff,238
600,651,51,1.938701486,1.698485988,442,516,186,1,'01_19_03.c3d',3,EV,B,E,3,diff,74
839,1354,515,2.032921217,1.717021511,534,703,49,1,'01_19_04.c3d',3,EV,B,E,4,diff,169
662,973,311,1.472110579,1.267909495,441,517,1,1,'01_19_05.c3d',3,EV,B,E,5,diff,76
1498,1953,455,1.225804639,1.015815075,1009,1337,26,1,'01_19_01.c3d',4,EV,B,E,1,diff,328
742,1148,406,2.345632264,1.210842787,530,723,340,1,'01_19_02.c3d',4,EV,B,E,2,diff,193
739,818,79,1.831498305,1.167418421,492,715,271,1,'01_19_03.c3d',4,EV,B,E,3,diff,223
1026,1697,671,1.579888129,1.155210806,506,673,271,262,'01_19_04.c3d',4,EV,B,E,4,diff,167
1176,1471,295,1.194118009,0.945616141,641,872,123,1,'01_19_05.c3d',4,EV,B,E,5,diff,231
741,1115,374,2.783780119,1.401373585,404,634,250,1,'01_19_01.c3d',5,EV,B,E,1,diff,230
782,1170,388,2.811125162,1.426788496,427,606,281,270,'01_19_02.c3d',5,EV,B,E,2,diff,179
527,865,338,1.410486535,1.418106144,245,337,1,1,'01_19_03.c3d',5,EV,B,E,3,diff,92
1073,1196,123,1.977084516,1.174877908,435,537,289,272,'01_19_04.c3d',5,EV,B,E,4,diff,102
753,783,30,2.043745675,1.538592796,400,541,76,237,'01_19_05.c3d',5,EV,B,E,5,diff,141
1272,1277,5,0.808922124,0.859806437,866,880,328,1,'01_19_01.c3d',6,EV,B,E,1,diff,14
1071,1137,66,1.507248226,1.242208815,653,730,28,1,'01_19_02.c3d',6,EV,B,E,2,diff,77
917,1268,351,1.500351023,1.376058747,512,778,1,314,'01_19_03.c3d',6,EV,B,E,3,diff,266
1049,1948,899,1.48407281,1.17131447,657,783,1,1,'01_19_04.c3d',6,EV,B,E,4,diff,126
826,1093,267,1.58563978,1.378596088,661,718,65,1,'01_19_05.c3d',6,EV,B,E,5,diff,57
1163,2055,892,1.299089005,0.814008207,706,856,493,1,'01_19_01.c3d',7,EV,B,E,1,diff,150
1057,1808,751,0.894152394,0.796141529,586,745,1,295,'01_19_02.c3d',7,EV,B,E,2,diff,159
1030,1081,51,1.205374514,0.817278412,550,753,323,291,'01_19_03.c3d',7,EV,B,E,3,diff,203
725,1562,837,1.232080683,1.051380559,386,630,1,1,'01_19_04.c3d',7,EV,B,E,4,diff,244
870,1750,880,1.41286268,0.965556267,544,636,268,244,'01_19_05.c3d',7,EV,B,E,5,diff,92
1079,1278,199,1.197560219,1.037122061,544,737,289,273,'01_19_01.c3d',8,EV,B,E,1,diff,193
1494,1861,367,0.768693296,0.779553578,678,1227,432,1,'01_19_02.c3d',8,EV,B,E,2,diff,549
1355,1404,49,0.943008941,0.815023424,467,737,201,241,'01_19_03.c3d',8,EV,B,E,3,diff,270
1111,1346,235,0.805470297,0.944541828,442,852,138,151,'01_19_04.c3d',8,EV,B,E,4,diff,410
1275,1863,588,0.670879158,0.67235194,361,848,91,130,'01_19_05.c3d',8,EV,B,E,5,diff,487
951,2062,1111,0.775113561,1.183188966,513,578,288,267,'01_19_01.c3d',9,EV,B,E,1,diff,65
800,1399,599,1.135749053,1.561012651,515,565,324,314,'01_19_02.c3d',9,EV,B,E,2,diff,50
1256,2097,841,1.676769368,1.261569301,478,588,281,258,'01_19_03.c3d',9,EV,B,E,3,diff,110
975,1074,99,1.499909669,1.22863353,525,608,295,1,'01_19_04.c3d',9,EV,B,E,4,diff,83
830,1428,598,1.695409091,1.307874119,460,597,270,263,'01_19_05.c3d',9,EV,B,E,5,diff,137
805,847,42,2.113048537,1.88320022,589,697,361,352,'01_19_01.c3d',10,EV,B,E,1,diff,108
891,960,69,1.562771535,1.707956037,567,772,72,148,'01_19_02.c3d',10,EV,B,E,2,diff,205
1095,1644,549,1.068090635,1.106479236,513,761,244,1,'01_19_03.c3d',10,EV,B,E,3,diff,248
734,826,92,2.028972301,1.91604264,440,596,225,235,'01_19_04.c3d',10,EV,B,E,4,diff,156
751,797,46,1.646888033,1.576771583,426,541,1,207,'01_19_05.c3d',10,EV,B,E,5,diff,115
1461,2057,596,0.719778539,0.726286027,1277,1250,41,1,'01_19_01.c3d',11,EV,B,E,1,diff,27
1457,1687,230,0.662320921,0.795325333,1202,1209,1,1,'01_19_02.c3d',11,EV,B,E,2,diff,7
1272,1881,609,0.798083806,0.796089703,605,1051,1,358,'01_19_03.c3d',11,EV,B,E,3,diff,446
2088,2656,568,0.559503235,0.586764496,691,1148,56,467,'01_19_04.c3d',11,EV,B,E,4,diff,457
1415,2805,1390,0.778425258,0.802844817,1156,1165,477,493,'01_19_05.c3d',11,EV,B,E,5,diff,9
906,1059,153,1.480009144,1.11510469,480,730,284,310,'01_19_01.c3d',12,EV,B,E,1,diff,250
995,1074,79,1.529181698,0.955812348,513,766,297,305,'01_19_02.c3d',12,EV,B,E,2,diff,253
1248,1339,91,1.533131229,1.068608905,872,1021,375,362,'01_19_03.c3d',12,EV,B,E,3,diff,149
928,1497,569,1.832144105,1.163401232,462,629,259,253,'01_19_04.c3d',12,EV,B,E,4,diff,167
778,1102,324,1.871993921,1.350353926,449,653,279,1,'01_19_05.c3d',12,EV,B,E,5,diff,204
1162,1177,15,1.599627939,1.051522398,641,917,338,1,'01_19_01.c3d',13,EV,B,E,1,diff,276
885,1664,779,1.398108447,1.201557672,628,793,1,1,'01_19_02.c3d',13,EV,B,E,2,diff,165
826,904,78,2.160757474,1.199245915,463,681,259,1,'01_19_03.c3d',13,EV,B,E,3,diff,218
832,1040,208,1.693068077,1.069277827,527,767,82,1,'01_19_04.c3d',13,EV,B,E,4,diff,240
970,1258,288,1.770430658,1.091416151,488,687,1,1,'01_19_05.c3d',13,EV,B,E,5,diff,199
661,1375,714,2.534885805,1.714099323,398,503,201,203,'01_19_01.c3d',14,EV,B,E,1,diff,105
711,1017,306,2.056431321,1.913555455,468,536,97,286,'01_19_02.c3d',14,EV,B,E,2,diff,68
654,1609,955,2.277658071,2.178317077,418,608,265,280,'01_19_03.c3d',14,EV,B,E,3,diff,190
651,1252,601,2.565609742,1.82739125,404,527,212,211,'01_19_04.c3d',14,EV,B,E,4,diff,123
909,999,90,1.768348977,1.591757271,400,601,1,52,'01_19_05.c3d',14,EV,B,E,5,diff,201
1065,1134,69,1.581126876,1.314183852,558,710,47,1,'01_19_01.c3d',15,EV,B,E,1,diff,152
779,796,17,1.815131149,1.629709082,465,653,250,265,'01_19_02.c3d',15,EV,B,E,2,diff,188
940,960,20,1.590502058,1.424862545,539,785,320,1,'01_19_03.c3d',15,EV,B,E,3,diff,246
910,1847,937,1.962414299,1.161227656,468,639,254,1,'01_19_04.c3d',15,EV,B,E,4,diff,171
920,1283,363,1.086036939,1.379007523,471,741,263,273,'01_19_05.c3d',15,EV,B,E,5,diff,270
856,923,67,2.573808171,1.320561323,495,620,42,1,'01_19_01.c3d',16,EV,B,E,1,diff,125
977,1124,147,1.105379824,1.391582221,426,625,66,102,'01_19_02.c3d',16,EV,B,E,2,diff,199
873,4191,3318,1.584593251,1.601530142,3160,628,333,285,'01_19_03.c3d',16,EV,B,E,3,diff,2532
1064,1575,511,1.313879165,1.219186324,534,606,209,192,'01_19_04.c3d',16,EV,B,E,4,diff,72
1024,1936,912,0.669727737,1.061237178,558,760,213,236,'01_19_05.c3d',16,EV,B,E,5,diff,202
554,571,17,3.331405149,2.224096944,386,491,246,245,'01_19_01.c3d',17,EV,B,E,1,diff,105
603,709,106,3.801362181,2.195995015,397,498,277,279,'01_19_02.c3d',17,EV,B,E,2,diff,101
535,543,8,4.265195962,2.584225113,359,351,247,1,'01_19_03.c3d',17,EV,B,E,3,diff,8
671,1678,1007,2.575634775,1.883884132,410,493,256,259,'01_19_04.c3d',17,EV,B,E,4,diff,83
613,620,7,2.649865458,1.923813845,414,567,260,258,'01_19_05.c3d',17,EV,B,E,5,diff,153
158,829,671,3.126292221,2.617052034,173,1,1,1,'01_19_01.c3d',18,EV,B,E,1,diff,172
768,833,65,2.041434805,1.914257717,521,809,1,315,'01_19_02.c3d',18,EV,B,E,2,diff,288
779,983,204,1.896575898,1.661955523,472,727,1,284,'01_19_03.c3d',18,EV,B,E,3,diff,255
879,900,21,1.846800907,1.598428967,489,753,266,1,'01_19_04.c3d',18,EV,B,E,4,diff,264
857,1030,173,1.976196291,1.502115976,457,640,1,287,'01_19_05.c3d',18,EV,B,E,5,diff,183
1026,1512,486,0.902786113,1.053885079,527,675,1,260,'01_19_01.c3d',19,EV,B,E,1,diff,148
773,823,50,1.685051906,1.255077281,473,601,246,242,'01_19_02.c3d',19,EV,B,E,2,diff,128
796,838,42,1.575457313,1.15961233,491,712,265,240,'01_19_03.c3d',19,EV,B,E,3,diff,221
829,850,21,1.584808153,1.455193262,543,618,165,267,'01_19_04.c3d',19,EV,B,E,4,diff,75
771,830,59,1.304299892,1.309255162,484,629,229,1,'01_19_05.c3d',19,EV,B,E,5,diff,145
1073,1554,481,1.404220428,1.244903716,488,667,302,285,'01_19_01.c3d',20,EV,B,E,1,diff,179
975,1412,437,1.779060816,1.360412937,556,742,376,342,'01_19_02.c3d',20,EV,B,E,2,diff,186
797,1283,486,1.665354849,1.411750275,449,549,231,193,'01_19_03.c3d',20,EV,B,E,3,diff,100
1336,1496,160,1.729117019,1.219447306,597,766,369,357,'01_19_04.c3d',20,EV,B,E,4,diff,169
924,1306,382,1.926024231,1.520732704,549,695,369,364,'01_19_05.c3d',20,EV,B,E,5,diff,146
1215,1217,2,1.041620253,0.831965303,585,964,349,1,'01_19_01.c3d',21,EV,B,E,1,diff,379
1416,1603,187,1.271720971,0.981257436,468,806,11,1,'01_19_02.c3d',21,EV,B,E,2,diff,338
1350,1351,1,1.272049342,0.654761012,563,627,320,319,'01_19_03.c3d',21,EV,B,E,3,diff,64
1037,1088,51,1.652317547,0.889492557,496,637,298,1,'01_19_04.c3d',21,EV,B,E,4,diff,141
1545,1718,173,1.270158173,0.825218638,696,989,498,517,'01_19_05.c3d',21,EV,B,E,5,diff,293
1194,1415,221,1.082395715,1.216266179,702,968,459,481,'01_19_01.c3d',22,EV,B,E,1,diff,266
1333,1522,189,0.982899112,1.245370162,705,1004,424,458,'01_19_02.c3d',22,EV,B,E,2,diff,299
1040,1115,75,1.178601394,1.562337043,658,846,286,361,'01_19_03.c3d',22,EV,B,E,3,diff,188
1084,1324,240,1.145479092,1.511706213,547,914,226,377,'01_19_04.c3d',22,EV,B,E,4,diff,367
1164,1695,531,0.961593967,1.320439991,539,984,51,350,'01_19_05.c3d',22,EV,B,E,5,diff,445
3001,5247,2246,0.824067654,0.512138185,561,1036,320,1,'01_19_01.c3d',23,EV,B,E,1,diff,475
3237,6163,2926,0.549666731,0.468149078,520,1642,251,267,'01_19_02.c3d',23,EV,B,E,2,diff,1122
3075,5294,2219,0.462407169,0.515169889,2943,993,37,290,'01_19_03.c3d',23,EV,B,E,3,diff,1950
2885,3795,910,0.695034913,0.519521414,675,1254,6,1,'01_19_04.c3d',23,EV,B,E,4,diff,579
3061,4226,1165,0.601212753,0.371141379,977,1909,36,292,'01_19_05.c3d',23,EV,B,E,5,diff,932
1549,2196,647,1.255347984,0.971371237,626,843,429,21,'01_19_01.c3d',24,EV,B,E,1,diff,217
989,1870,881,1.571073332,0.941464224,415,754,225,239,'01_19_02.c3d',24,EV,B,E,2,diff,339
889,1070,181,1.486896426,1.220898529,485,748,252,1,'01_19_03.c3d',24,EV,B,E,3,diff,263
865,958,93,1.164893337,1.029887343,446,662,205,1,'01_19_04.c3d',24,EV,B,E,4,diff,216
1041,3041,2000,1.349274878,1.015700425,516,869,284,1,'01_19_05.c3d',24,EV,B,E,5,diff,353
755,1232,477,2.626841388,1.605491533,495,526,336,332,'01_19_01.c3d',25,EV,B,E,1,diff,31
898,1042,144,1.576633494,1.207643632,508,611,268,264,'01_19_02.c3d',25,EV,B,E,2,diff,103
1074,1206,132,1.169969603,1.075741226,642,696,59,308,'01_19_03.c3d',25,EV,B,E,3,diff,54
1018,1771,753,1.244751799,0.888945366,574,647,259,261,'01_19_04.c3d',25,EV,B,E,4,diff,73
992,1748,756,0.891015675,0.85021455,472,786,260,252,'01_19_05.c3d',25,EV,B,E,5,diff,314
2157,2832,675,0.889526407,0.797557124,519,838,336,335,'01_19_01.c3d',26,EV,B,E,1,diff,319
1850,2505,655,0.800948635,0.799812964,469,866,1,1,'01_19_02.c3d',26,EV,B,E,2,diff,397
901,921,20,1.242490861,0.823705054,447,709,183,1,'01_19_03.c3d',26,EV,B,E,3,diff,262
1004,1008,4,1.137197728,0.824411519,489,863,1,1,'01_19_04.c3d',26,EV,B,E,4,diff,374
952,2454,1502,1.008913329,1.026637889,501,795,266,296,'01_19_05.c3d',26,EV,B,E,5,diff,294
1152,2367,1215,1.302475739,1.237065646,653,967,393,414,'01_19_01.c3d',27,EV,B,E,1,diff,314
1539,1872,333,0.927361007,0.969208032,766,1005,1,468,'01_19_02.c3d',27,EV,B,E,2,diff,239
1313,1559,246,0.794095096,1.131434406,637,909,309,1,'01_19_03.c3d',27,EV,B,E,3,diff,272
1547,2166,619,0.767742693,1.077112714,877,1134,1,1,'01_19_04.c3d',27,EV,B,E,4,diff,257
1334,1990,656,0.816599703,0.958203073,1039,994,1,403,'01_19_05.c3d',27,EV,B,E,5,diff,45
1220,1329,109,1.133432761,1.0541951,715,1067,450,481,'01_19_01.c3d',28,EV,B,E,1,diff,352
1163,1661,498,1.072144983,0.786100259,737,1150,416,1,'01_19_02.c3d',28,EV,B,E,2,diff,413
1050,1182,132,1.286316379,1.070013335,585,918,98,1,'01_19_03.c3d',28,EV,B,E,3,diff,333
1395,1409,14,0.957542783,0.940115947,875,1069,255,260,'01_19_04.c3d',28,EV,B,E,4,diff,194
1356,1481,125,0.69095555,0.930351786,1114,1088,1,311,'01_19_05.c3d',28,EV,B,E,5,diff,26
801,1496,695,1.628819626,1.672471259,530,697,302,1,'01_19_01.c3d',29,EV,B,E,1,diff,167
859,1722,863,1.562588956,1.429651129,516,699,1,285,'01_19_02.c3d',29,EV,B,E,2,diff,183
987,1340,353,1.409382623,1.459964538,621,758,381,389,'01_19_03.c3d',29,EV,B,E,3,diff,137
1045,1556,511,1.112006381,1.109648328,573,810,1,329,'01_19_04.c3d',29,EV,B,E,4,diff,237
952,1223,271,1.50686961,1.387111101,629,776,348,367,'01_19_05.c3d',29,EV,B,E,5,diff,147
913,924,11,1.526729257,1.302566367,634,831,1,1,'01_19_01.c3d',30,EV,B,E,1,diff,197
961,1058,97,1.597147678,0.990935259,514,656,1,285,'01_19_02.c3d',30,EV,B,E,2,diff,142
1186,1458,272,1.074150184,0.849426025,629,826,1,1,'01_19_03.c3d',30,EV,B,E,3,diff,197
916,949,33,1.031651312,0.877198104,461,615,147,1,'01_19_04.c3d',30,EV,B,E,4,diff,154
972,1382,410,1.005006272,0.89325035,505,827,39,128,'01_19_05.c3d',30,EV,B,E,5,diff,322
904,1028,124,2.078275516,1.845148604,584,682,379,384,'01_19_01.c3d',31,EV,B,E,1,diff,98
1033,1103,70,1.928075564,1.375258679,621,758,311,314,'01_19_02.c3d',31,EV,B,E,2,diff,137
939,1074,135,2.515261801,1.624175395,610,707,383,374,'01_19_03.c3d',31,EV,B,E,3,diff,97
918,1282,364,2.095389957,1.515047385,537,714,327,320,'01_19_04.c3d',31,EV,B,E,4,diff,177
1114,1313,199,1.644693872,1.392490146,530,694,325,329,'01_19_05.c3d',31,EV,B,E,5,diff,164
1070,1654,584,1.312269975,1.358109484,690,911,425,1,'01_19_01.c3d',32,EV,B,E,1,diff,221
858,1797,939,1.39191639,1.467418107,521,776,297,306,'01_19_02.c3d',32,EV,B,E,2,diff,255
953,968,15,1.520744047,1.159118528,512,799,306,310,'01_19_03.c3d',32,EV,B,E,3,diff,287
1135,1275,140,1.006872184,1.133055722,774,854,290,272,'01_19_04.c3d',32,EV,B,E,4,diff,80
1249,1288,39,1.170678023,1.16764855,795,844,300,1,'01_19_05.c3d',32,EV,B,E,5,diff,49
1432,2153,721,0.918071446,0.894351797,612,983,355,347,'01_19_01.c3d',33,EV,B,E,1,diff,371
1111,1540,429,1.148913776,1.186564836,682,967,399,381,'01_19_02.c3d',33,EV,B,E,2,diff,285
1140,1799,659,1.475710841,1.254148695,820,1041,517,490,'01_19_03.c3d',33,EV,B,E,3,diff,221
1024,1122,98,1.21399394,1.045842453,537,893,278,253,'01_19_04.c3d',33,EV,B,E,4,diff,356
1157,1308,151,1.138518635,1.056788693,599,911,310,1,'01_19_05.c3d',33,EV,B,E,5,diff,312
1230,2050,820,0.900878816,1.111581451,825,992,1,422,'01_19_01.c3d',34,EV,B,E,1,diff,167
1023,1040,17,1.691268067,1.55616164,780,943,1,417,'01_19_02.c3d',34,EV,B,E,2,diff,163
700,1007,307,2.080317912,1.455554189,450,636,264,257,'01_19_03.c3d',34,EV,B,E,3,diff,186
1169,1769,600,0.845768804,0.87382537,501,791,299,281,'01_19_04.c3d',34,EV,B,E,4,diff,290
997,1071,74,1.171859354,1.258580338,690,815,436,456,'01_19_05.c3d',34,EV,B,E,5,diff,125
919,968,49,1.707241699,1.072392891,421,623,226,223,'01_19_01.c3d',35,EV,B,E,1,diff,202
986,1092,106,2.131386845,1.289752085,593,721,387,1,'01_19_02.c3d',35,EV,B,E,2,diff,128
919,1006,87,2.217220594,1.283209354,500,712,6,1,'01_19_03.c3d',35,EV,B,E,3,diff,212
874,1052,178,1.723789903,1.245017688,494,691,254,1,'01_19_04.c3d',35,EV,B,E,4,diff,197
1273,1829,556,1.644586045,0.993335622,544,689,311,1,'01_19_05.c3d',35,EV,B,E,5,diff,145
1205,2041,836,0.810919395,0.785875906,872,979,138,167,'01_21_01.c3d',1,EV,B,H,1,diff,107
1155,1357,202,1.19564202,0.939224502,550,896,267,276,'01_21_02.c3d',1,EV,B,H,2,diff,346
831,1972,1141,0.985239114,0.883270796,456,633,1,1,'01_21_03.c3d',1,EV,B,H,3,diff,177
1546,2732,1186,0.795073362,0.854052782,1060,1299,379,391,'01_21_04.c3d',1,EV,B,H,4,diff,239
1309,1361,52,0.933465048,0.855527469,577,977,77,1,'01_21_05.c3d',1,EV,B,H,5,diff,400
2006,2375,369,1.038702587,0.899854464,564,1199,23,168,'01_21_01.c3d',2,EV,B,H,1,diff,635
1276,2347,1071,1.006252625,1.012720996,541,1142,59,248,'01_21_02.c3d',2,EV,B,H,2,diff,601
1460,1734,274,0.962587766,0.869335697,507,1047,285,1,'01_21_03.c3d',2,EV,B,H,3,diff,540
1408,2024,616,0.947374276,0.864908586,499,1183,282,1,'01_21_04.c3d',2,EV,B,H,4,diff,684
2012,2293,281,0.762403391,0.639421402,535,1409,50,1,'01_21_05.c3d',2,EV,B,H,5,diff,874
1351,2624,1273,0.668415928,0.893257017,615,901,1,1,'01_21_01.c3d',3,EV,B,H,1,diff,286
871,1024,153,1.812855948,1.390124134,481,782,140,250,'01_21_02.c3d',3,EV,B,H,2,diff,301
2016,2317,301,1.220133238,1.370101106,1714,1861,1,558,'01_21_03.c3d',3,EV,B,H,3,diff,147
846,1374,528,1.366582478,0.798202223,454,728,239,286,'01_21_04.c3d',3,EV,B,H,4,diff,274
1011,1298,287,1.32002166,1.282217424,567,828,401,412,'01_21_05.c3d',3,EV,B,H,5,diff,261
1073,1340,267,1.488299709,0.935384911,547,940,314,326,'01_21_01.c3d',4,EV,B,H,1,diff,393
1017,1091,74,1.530214303,0.847878319,507,791,1,271,'01_21_02.c3d',4,EV,B,H,2,diff,284
778,1012,234,1.792319211,0.912385042,503,797,93,1,'01_21_03.c3d',4,EV,B,H,3,diff,294
987,2257,1270,0.976122964,0.987162054,445,769,92,270,'01_21_04.c3d',4,EV,B,H,4,diff,324
1096,1606,510,1.069854303,0.95360936,517,839,1,1,'01_21_05.c3d',4,EV,B,H,5,diff,322
813,1839,1026,2.920348013,1.140026315,628,811,485,1,'01_21_01.c3d',5,EV,B,H,1,diff,183
878,1052,174,2.144396146,1.350254214,465,662,277,271,'01_21_02.c3d',5,EV,B,H,2,diff,197
825,916,91,2.51188998,1.500931883,495,565,1,330,'01_21_03.c3d',5,EV,B,H,3,diff,70
1280,1811,531,2.288205172,1.340317339,423,619,286,1,'01_21_04.c3d',5,EV,B,H,4,diff,196
929,1226,297,1.861120161,1.594157281,574,623,1,349,'01_21_05.c3d',5,EV,B,H,5,diff,49
1100,1131,31,1.590760842,0.928804117,566,739,1,289,'01_21_01.c3d',6,EV,B,H,1,diff,173
1337,1756,419,1.055629321,0.784006004,630,937,1,1,'01_21_02.c3d',6,EV,B,H,2,diff,307
1021,1923,902,1.107776641,0.989524488,735,816,1,1,'01_21_03.c3d',6,EV,B,H,3,diff,81
1628,2263,635,1.081397652,0.871366245,796,731,1,1,'01_21_04.c3d',6,EV,B,H,4,diff,65
1014,1035,21,1.162656275,1.088472564,522,775,307,321,'01_21_05.c3d',6,EV,B,H,5,diff,253
1057,1081,24,1.409519729,0.705057514,502,744,48,266,'01_21_01.c3d',7,EV,B,H,1,diff,242
1102,1125,23,1.120161745,0.636276884,411,704,1,170,'01_21_02.c3d',7,EV,B,H,2,diff,293
816,844,28,1.252428438,0.895385209,392,650,1,95,'01_21_03.c3d',7,EV,B,H,3,diff,258
910,919,9,1.074655577,0.757440213,473,614,52,58,'01_21_04.c3d',7,EV,B,H,4,diff,141
806,861,55,1.219083562,0.635995742,420,656,1,1,'01_21_05.c3d',7,EV,B,H,5,diff,236
1864,2461,597,0.993799598,0.878473371,620,1075,1,1,'01_21_01.c3d',8,EV,B,H,1,diff,455
1572,2272,700,0.673177283,0.700198752,528,1020,50,1,'01_21_02.c3d',8,EV,B,H,2,diff,492
1468,2202,734,0.711218636,0.783145353,545,1111,311,329,'01_21_03.c3d',8,EV,B,H,3,diff,566
1156,2637,1481,0.900019505,0.829506229,500,829,1,79,'01_21_04.c3d',8,EV,B,H,4,diff,329
1655,3408,1753,0.836955357,0.581324706,643,1005,1,310,'01_21_05.c3d',8,EV,B,H,5,diff,362
2755,3240,485,0.848738306,0.665306009,585,841,1,387,'01_21_01.c3d',9,EV,B,H,1,diff,256
959,1653,694,1.213816081,1.053179186,522,531,1,267,'01_21_02.c3d',9,EV,B,H,2,diff,9
1017,1920,903,0.727485668,1.068789976,656,548,16,262,'01_21_03.c3d',9,EV,B,H,3,diff,108
1533,2308,775,1.067424008,0.725378415,596,636,287,1,'01_21_04.c3d',9,EV,B,H,4,diff,40
1108,1354,246,1.31196867,0.853405723,449,795,256,252,'01_21_05.c3d',9,EV,B,H,5,diff,346
1109,2696,1587,1.737914277,1.802603688,735,868,112,486,'01_21_01.c3d',10,EV,B,H,1,diff,133
1020,2109,1089,2.672909236,1.517484658,549,718,377,334,'01_21_02.c3d',10,EV,B,H,2,diff,169
773,837,64,1.828767874,1.959120049,521,681,308,297,'01_21_03.c3d',10,EV,B,H,3,diff,160
1006,1667,661,1.173416742,1.288067312,492,774,74,280,'01_21_04.c3d',10,EV,B,H,4,diff,282
885,907,22,1.339880911,1.314282963,465,692,1,1,'01_21_05.c3d',10,EV,B,H,5,diff,227
1844,1984,140,0.54098509,0.541109769,979,1435,7,394,'01_21_01.c3d',11,EV,B,H,1,diff,456
1472,2603,1131,0.710484864,0.706037978,929,1262,45,352,'01_21_02.c3d',11,EV,B,H,2,diff,333
1699,2849,1150,0.538724115,0.662738121,1101,1219,1,421,'01_21_03.c3d',11,EV,B,H,3,diff,118
1253,2369,1116,0.607700392,0.769845567,1079,1098,266,1,'01_21_04.c3d',11,EV,B,H,4,diff,19
1681,2941,1260,0.707768695,0.664364623,555,1117,74,1,'01_21_05.c3d',11,EV,B,H,5,diff,562
880,1412,532,1.448152022,1.05794487,409,679,43,1,'01_21_01.c3d',12,EV,B,H,1,diff,270
959,1334,375,1.408294968,1.110390122,497,761,316,310,'01_21_02.c3d',12,EV,B,H,2,diff,264
1057,1074,17,1.520091321,0.986307314,535,849,43,341,'01_21_03.c3d',12,EV,B,H,3,diff,314
1245,1887,642,1.075465595,0.845786654,540,887,317,343,'01_21_04.c3d',12,EV,B,H,4,diff,347
972,1792,820,1.732809571,0.956383909,471,809,298,277,'01_21_05.c3d',12,EV,B,H,5,diff,338
1243,1746,503,1.486852572,0.927100273,708,939,1,1,'01_21_01.c3d',13,EV,B,H,1,diff,231
1131,1150,19,1.312477864,0.839914982,452,854,247,1,'01_21_02.c3d',13,EV,B,H,2,diff,402
977,2364,1387,1.683791939,1.050724522,453,749,243,250,'01_21_03.c3d',13,EV,B,H,3,diff,296
945,2136,1191,1.452757456,1.226280006,516,608,299,1,'01_21_04.c3d',13,EV,B,H,4,diff,92
1122,1276,154,1.170048169,0.959140099,552,853,72,311,'01_21_05.c3d',13,EV,B,H,5,diff,301
1728,1761,33,1.419183883,0.676015104,730,1080,538,540,'01_21_01.c3d',14,EV,B,H,1,diff,350
820,1014,194,1.77417228,1.917287756,449,706,68,1,'01_21_02.c3d',14,EV,B,H,2,diff,257
771,1739,968,2.240347512,1.644576806,393,625,230,225,'01_21_03.c3d',14,EV,B,H,3,diff,232
907,2550,1643,2.039304868,1.292553036,483,665,317,314,'01_21_04.c3d',14,EV,B,H,4,diff,182
863,908,45,1.981783675,1.561323674,472,755,1,324,'01_21_05.c3d',14,EV,B,H,5,diff,283
1083,1506,423,1.420914111,1.226167305,534,877,1,333,'01_21_01.c3d',15,EV,B,H,1,diff,343
973,982,9,1.747424942,1.188834384,459,782,247,247,'01_21_02.c3d',15,EV,B,H,2,diff,323
1054,1060,6,1.504512225,1.179269185,535,825,151,1,'01_21_03.c3d',15,EV,B,H,3,diff,290
1097,1631,534,0.995211842,0.900289193,576,856,1,84,'01_21_04.c3d',15,EV,B,H,4,diff,280
993,1520,527,1.196005203,1.290352624,476,780,243,313,'01_21_05.c3d',15,EV,B,H,5,diff,304
1316,1388,72,1.377314702,0.907617449,628,921,336,351,'01_21_01.c3d',16,EV,B,H,1,diff,293
953,3424,2471,1.374775615,1.292616725,411,731,202,1,'01_21_02.c3d',16,EV,B,H,2,diff,320
1255,1656,401,1.390130387,1.164153882,668,1029,474,443,'01_21_03.c3d',16,EV,B,H,3,diff,361
908,958,50,1.359480037,0.94690491,465,735,103,102,'01_21_04.c3d',16,EV,B,H,4,diff,270
1111,3639,2528,0.959527796,1.013360789,412,880,118,174,'01_21_05.c3d',16,EV,B,H,5,diff,468
784,836,52,2.904917651,1.585228566,519,682,362,1,'01_21_01.c3d',17,EV,B,H,1,diff,163
679,1372,693,4.163718952,1.649395712,388,520,253,253,'01_21_02.c3d',17,EV,B,H,2,diff,132
993,1366,373,3.122075728,1.477624627,515,678,386,371,'01_21_03.c3d',17,EV,B,H,3,diff,163
721,836,115,3.170354422,1.469564115,387,534,265,260,'01_21_04.c3d',17,EV,B,H,4,diff,147
690,786,96,2.178541318,1.505108133,415,548,269,1,'01_21_05.c3d',17,EV,B,H,5,diff,133
785,871,86,2.114892395,1.91740504,524,805,262,1,'01_21_01.c3d',18,EV,B,H,1,diff,281
689,961,272,2.035713281,1.610009452,507,787,291,309,'01_21_02.c3d',18,EV,B,H,2,diff,280
538,977,439,1.463995959,1.40952376,452,611,1,1,'01_21_03.c3d',18,EV,B,H,3,diff,159
749,950,201,1.689840035,1.386367844,516,741,1,295,'01_21_04.c3d',18,EV,B,H,4,diff,225
801,831,30,1.603574792,1.344029688,427,693,1,1,'01_21_05.c3d',18,EV,B,H,5,diff,266
1363,1372,9,0.979386076,0.816688531,478,808,128,1,'01_21_01.c3d',19,EV,B,H,1,diff,330
982,1001,19,1.505707905,1.411184143,456,636,267,262,'01_21_02.c3d',19,EV,B,H,2,diff,180
1215,1442,227,0.733663966,0.747333603,487,814,1,279,'01_21_03.c3d',19,EV,B,H,3,diff,327
1046,1106,60,1.805477462,1.293972134,456,662,267,258,'01_21_04.c3d',19,EV,B,H,4,diff,206
1028,1208,180,1.522819211,0.937799835,417,643,1,204,'01_21_05.c3d',19,EV,B,H,5,diff,226
956,1092,136,1.772842502,1.203550284,524,642,345,320,'01_21_01.c3d',20,EV,B,H,1,diff,118
1350,1884,534,1.58552771,1.068229372,808,958,632,1,'01_21_02.c3d',20,EV,B,H,2,diff,150
1043,1185,142,1.571976169,0.91060383,491,670,283,1,'01_21_03.c3d',20,EV,B,H,3,diff,179
1195,1223,28,1.284783675,0.776664974,460,632,1,1,'01_21_04.c3d',20,EV,B,H,4,diff,172
1106,1168,62,1.478141112,0.875132915,458,704,288,270,'01_21_05.c3d',20,EV,B,H,5,diff,246
1049,1141,92,1.328460331,0.925635165,465,803,280,271,'01_21_01.c3d',21,EV,B,H,1,diff,338
1357,1426,69,1.329374794,0.690772975,555,893,1,1,'01_21_02.c3d',21,EV,B,H,2,diff,338
1350,2469,1119,0.800428831,0.663160647,569,1207,74,165,'01_21_03.c3d',21,EV,B,H,3,diff,638
1200,1236,36,0.812438881,0.795269063,415,1062,1,1,'01_21_04.c3d',21,EV,B,H,4,diff,647
1357,1458,101,0.940741735,0.616306497,546,1015,353,351,'01_21_05.c3d',21,EV,B,H,5,diff,469
1328,1380,52,1.184750595,1.031491179,553,856,338,340,'01_21_01.c3d',22,EV,B,H,1,diff,303
1198,2062,864,1.092145701,1.504370348,630,983,335,366,'01_21_02.c3d',22,EV,B,H,2,diff,353
1483,1857,374,0.714432108,1.361475344,920,1026,366,448,'01_21_03.c3d',22,EV,B,H,3,diff,106
1599,2480,881,0.77508199,0.998782013,1004,1002,288,384,'01_21_04.c3d',22,EV,B,H,4,diff,2
1697,1883,186,0.652530816,0.947547386,740,1180,1,513,'01_21_05.c3d',22,EV,B,H,5,diff,440
4567,5240,673,0.737094595,0.574675443,661,1337,32,367,'01_21_01.c3d',23,EV,B,H,1,diff,676
2400,3389,989,0.687002571,0.6252759,2878,1717,43,307,'01_21_02.c3d',23,EV,B,H,2,diff,1161
4696,5846,1150,0.329418514,0.475609056,3204,1251,1,1,'01_21_03.c3d',23,EV,B,H,3,diff,1953
2669,5711,3042,0.310705252,0.547503203,3619,1708,44,386,'01_21_04.c3d',23,EV,B,H,4,diff,1911
3378,6555,3177,0.604529,0.417284318,4168,2288,1,1,'01_21_05.c3d',23,EV,B,H,5,diff,1880
1270,1307,37,1.361665859,0.834640585,502,832,290,298,'01_21_01.c3d',24,EV,B,H,1,diff,330
1073,1173,100,1.526448914,1.047382113,508,690,57,322,'01_21_02.c3d',24,EV,B,H,2,diff,182
1057,1118,61,1.065978729,0.995048055,376,802,60,1,'01_21_03.c3d',24,EV,B,H,3,diff,426
1136,1246,110,1.228224543,0.88726572,476,938,284,294,'01_21_04.c3d',24,EV,B,H,4,diff,462
1212,1272,60,1.137099401,0.843471924,473,995,75,1,'01_21_05.c3d',24,EV,B,H,5,diff,522
1192,1600,408,1.248477349,0.809801756,517,780,294,297,'01_21_01.c3d',25,EV,B,H,1,diff,263
999,1018,19,2.05569731,1.225218561,572,631,361,350,'01_21_02.c3d',25,EV,B,H,2,diff,59
1101,1105,4,1.147218778,0.856919187,502,729,271,269,'01_21_03.c3d',25,EV,B,H,3,diff,227
1098,1250,152,1.325739809,0.79470132,478,611,52,241,'01_21_04.c3d',25,EV,B,H,4,diff,133
1088,2177,1089,1.042227015,0.807413453,486,650,25,271,'01_21_05.c3d',25,EV,B,H,5,diff,164
1426,2481,1055,0.999995992,0.526749771,568,1104,22,1,'01_21_01.c3d',26,EV,B,H,1,diff,536
1306,3244,1938,0.595937138,0.681628357,590,1057,1,340,'01_21_02.c3d',26,EV,B,H,2,diff,467
1265,3364,2099,1.138477352,0.551635113,468,662,243,1,'01_21_03.c3d',26,EV,B,H,3,diff,194
1489,1615,126,0.855724516,0.63325899,657,1168,17,420,'01_21_04.c3d',26,EV,B,H,4,diff,511
1141,1365,224,1.013155399,0.596657314,467,1146,1,244,'01_21_05.c3d',26,EV,B,H,5,diff,679
1395,2525,1130,0.771345555,0.849787114,674,1179,17,451,'01_21_01.c3d',27,EV,B,H,1,diff,505
1440,1525,85,1.055769991,0.96853875,745,1196,1,523,'01_21_02.c3d',27,EV,B,H,2,diff,451
1623,1702,79,0.963644863,0.945535829,774,1172,536,1,'01_21_03.c3d',27,EV,B,H,3,diff,398
1680,2238,558,0.660794207,0.768463319,666,968,389,374,'01_21_04.c3d',27,EV,B,H,4,diff,302
1377,1396,19,1.097488707,0.884672991,570,1030,43,391,'01_21_05.c3d',27,EV,B,H,5,diff,460
1316,2825,1509,1.250113311,1.087765486,545,2482,340,1680,'01_21_01.c3d',28,EV,B,H,1,diff,1937
3016,3576,560,0.531560446,0.545490029,2280,1363,50,1,'01_21_02.c3d',28,EV,B,H,2,diff,917
1249,1418,169,0.946329646,0.894090787,836,978,1,331,'01_21_03.c3d',28,EV,B,H,3,diff,142
1350,1615,265,0.89778357,0.979204054,520,913,264,1,'01_21_04.c3d',28,EV,B,H,4,diff,393
1652,1707,55,0.92400598,0.818166535,1300,1422,561,1,'01_21_05.c3d',28,EV,B,H,5,diff,122
935,2442,1507,1.749608757,1.355031024,463,624,1,1,'01_21_01.c3d',29,EV,B,H,1,diff,161
885,1985,1100,1.811565041,1.28347794,455,668,261,1,'01_21_02.c3d',29,EV,B,H,2,diff,213
937,2724,1787,1.464342747,1.272339511,482,691,1,268,'01_21_03.c3d',29,EV,B,H,3,diff,209
1049,1105,56,1.420161581,1.054008033,516,867,1,310,'01_21_04.c3d',29,EV,B,H,4,diff,351
1188,1383,195,1.105736096,0.803946071,539,816,300,337,'01_21_05.c3d',29,EV,B,H,5,diff,277
1108,1161,53,1.885737983,0.933991815,622,782,396,415,'01_21_01.c3d',30,EV,B,H,1,diff,160
1094,1444,350,1.20534448,0.770864597,478,744,60,274,'01_21_02.c3d',30,EV,B,H,2,diff,266
1138,1384,246,0.977695421,0.824257724,524,835,281,282,'01_21_03.c3d',30,EV,B,H,3,diff,311
1218,1426,208,0.684335107,0.738584218,498,813,261,273,'01_21_04.c3d',30,EV,B,H,4,diff,315
939,1150,211,1.175379027,0.725834024,487,690,163,1,'01_21_05.c3d',30,EV,B,H,5,diff,203
1098,2423,1325,1.660371902,1.263829716,622,824,411,1,'01_21_01.c3d',31,EV,B,H,1,diff,202
972,1494,522,2.174843886,1.724967574,619,747,428,436,'01_21_02.c3d',31,EV,B,H,2,diff,128
1207,3236,2029,1.735832142,1.331554247,751,922,480,478,'01_21_03.c3d',31,EV,B,H,3,diff,171
1090,2245,1155,1.887311677,1.150530504,491,751,292,280,'01_21_04.c3d',31,EV,B,H,4,diff,260
925,1354,429,2.190183335,1.033805098,486,704,313,304,'01_21_05.c3d',31,EV,B,H,5,diff,218
1044,1929,885,1.534270362,1.121007562,503,774,277,1,'01_21_01.c3d',32,EV,B,H,1,diff,271
1003,1121,118,1.515480092,1.20467098,561,815,320,333,'01_21_02.c3d',32,EV,B,H,2,diff,254
1052,1915,863,1.468176788,0.985753395,490,837,274,287,'01_21_03.c3d',32,EV,B,H,3,diff,347
1116,2523,1407,1.34776563,0.958221869,529,950,5,331,'01_21_04.c3d',32,EV,B,H,4,diff,421
1263,1343,80,1.017179334,0.958833584,892,1066,271,294,'01_21_05.c3d',32,EV,B,H,5,diff,174
1580,2719,1139,0.482240501,0.719704537,623,1149,1,386,'01_21_01.c3d',33,EV,B,H,1,diff,526
1206,1977,771,1.027944133,0.99709817,626,953,343,337,'01_21_02.c3d',33,EV,B,H,2,diff,327
1493,1586,93,0.872248941,0.888474102,774,1331,25,1,'01_21_03.c3d',33,EV,B,H,3,diff,557
1214,1508,294,1.019805955,0.877119674,653,912,73,298,'01_21_04.c3d',33,EV,B,H,4,diff,259
1463,1869,406,0.740795658,0.809905684,1045,1128,398,378,'01_21_05.c3d',33,EV,B,H,5,diff,83
911,1150,239,1.79796671,1.11983072,427,638,243,205,'01_21_01.c3d',34,EV,B,H,1,diff,211
771,1001,230,1.634553208,1.367660496,436,674,1,1,'01_21_02.c3d',34,EV,B,H,2,diff,238
728,873,145,1.28468661,1.525171244,606,680,19,1,'01_21_03.c3d',34,EV,B,H,3,diff,74
927,1355,428,1.095028338,1.075066151,506,699,261,245,'01_21_04.c3d',34,EV,B,H,4,diff,193
936,975,39,1.247368234,0.910818609,473,694,275,46,'01_21_05.c3d',34,EV,B,H,5,diff,221
887,1082,195,2.225905766,0.885947134,384,666,130,141,'01_21_01.c3d',35,EV,B,H,1,diff,282
1182,1470,288,1.417478046,0.916320583,457,739,247,1,'01_21_02.c3d',35,EV,B,H,2,diff,282
995,1060,65,1.495137574,0.978626148,395,761,164,169,'01_21_03.c3d',35,EV,B,H,3,diff,366
911,913,2,1.077653164,0.936547441,247,589,1,1,'01_21_04.c3d',35,EV,B,H,4,diff,342
943,1078,135,1.729859655,1.005899889,438,691,246,253,'01_21_05.c3d',35,EV,B,H,5,diff,253
1034,2610,1576,0.99017053,1.016760303,535,775,282,285,'01_20_01.c3d',1,EV,B,M,1,diff,240
1161,1193,32,1.200910722,0.935848737,500,845,209,193,'01_20_02.c3d',1,EV,B,M,2,diff,345
835,1435,600,1.071493786,1.100620798,582,742,1,1,'01_20_03.c3d',1,EV,B,M,3,diff,160
1330,2236,906,0.566514685,0.694922918,531,1144,1,113,'01_20_04.c3d',1,EV,B,M,4,diff,613
1382,2446,1064,0.698312865,0.609097686,400,930,27,1,'01_20_05.c3d',1,EV,B,M,5,diff,530
1761,2294,533,0.894119733,0.688361021,686,1329,1,15,'01_20_01.c3d',2,EV,B,M,1,diff,643
1167,2094,927,1.213125461,0.783088158,651,1370,215,1,'01_20_02.c3d',2,EV,B,M,2,diff,719
1349,3376,2027,0.965507281,0.891110913,522,1074,246,1,'01_20_03.c3d',2,EV,B,M,3,diff,552
1287,1385,98,0.867231817,0.925698872,446,1126,172,1,'01_20_04.c3d',2,EV,B,M,4,diff,680
1765,1891,126,0.690253573,0.753880241,623,1141,280,1,'01_20_05.c3d',2,EV,B,M,5,diff,518
827,837,10,1.773656058,1.501845168,454,717,245,1,'01_20_01.c3d',3,EV,B,M,1,diff,263
805,945,140,1.762082416,1.697811792,511,740,31,304,'01_20_02.c3d',3,EV,B,M,2,diff,229
830,920,90,1.577505969,1.467492836,467,641,261,252,'01_20_03.c3d',3,EV,B,M,3,diff,174
799,950,151,1.62410914,1.235055552,417,683,207,1,'01_20_04.c3d',3,EV,B,M,4,diff,266
774,946,172,1.731357125,1.509739228,473,694,271,292,'01_20_05.c3d',3,EV,B,M,5,diff,221
944,983,39,1.826854951,1.149210163,551,761,1,1,'01_20_01.c3d',4,EV,B,M,1,diff,210
993,1011,18,1.188118262,0.93095656,545,807,266,278,'01_20_02.c3d',4,EV,B,M,2,diff,262
1044,1078,34,1.291886394,0.850367037,534,844,291,1,'01_20_03.c3d',4,EV,B,M,3,diff,310
860,1067,207,1.386191726,0.872901439,494,884,1,286,'01_20_04.c3d',4,EV,B,M,4,diff,390
1095,1122,27,1.532707685,0.844815847,586,997,346,341,'01_20_05.c3d',4,EV,B,M,5,diff,411
505,1397,892,1.725761249,1.708711489,227,371,48,1,'01_20_01.c3d',5,EV,B,M,1,diff,144
758,1632,874,2.390351125,1.917816908,533,656,365,329,'01_20_02.c3d',5,EV,B,M,2,diff,123
559,859,300,2.540427544,1.28299221,406,484,252,1,'01_20_03.c3d',5,EV,B,M,3,diff,78
736,801,65,2.083871935,1.467105839,388,588,134,233,'01_20_04.c3d',5,EV,B,M,4,diff,200
654,945,291,2.099977597,1.469779674,433,596,274,1,'01_20_05.c3d',5,EV,B,M,5,diff,163
1230,1266,36,1.172221327,1.101028511,689,847,463,1,'01_20_01.c3d',6,EV,B,M,1,diff,158
1020,1339,319,1.897630448,1.041266585,588,816,1,1,'01_20_02.c3d',6,EV,B,M,2,diff,228
1002,1294,292,1.167570391,0.867721652,508,798,309,1,'01_20_03.c3d',6,EV,B,M,3,diff,290
1149,1389,240,1.193838183,0.954775775,941,883,1,403,'01_20_04.c3d',6,EV,B,M,4,diff,58
1016,1041,25,1.338651719,1.119175326,550,780,1,1,'01_20_05.c3d',6,EV,B,M,5,diff,230
1096,1126,30,1.519398658,0.848021389,603,853,374,364,'01_20_01.c3d',7,EV,B,M,1,diff,250
998,1026,28,1.367593293,0.869672519,499,803,1,1,'01_20_02.c3d',7,EV,B,M,2,diff,304
1059,1404,345,1.272244626,0.814174078,481,707,255,25,'01_20_03.c3d',7,EV,B,M,3,diff,226
945,1033,88,1.193972767,0.634150281,425,757,1,1,'01_20_04.c3d',7,EV,B,M,4,diff,332
680,930,250,1.023807265,0.895567857,387,487,1,1,'01_20_05.c3d',7,EV,B,M,5,diff,100
1259,2405,1146,1.169125582,0.882225943,616,894,1,356,'01_20_01.c3d',8,EV,B,M,1,diff,278
1465,2710,1245,0.761850111,0.818872093,665,1225,318,412,'01_20_02.c3d',8,EV,B,M,2,diff,560
1273,1532,259,0.753492149,0.785642485,414,1094,80,216,'01_20_03.c3d',8,EV,B,M,3,diff,680
1183,1327,144,0.896720045,0.836502672,439,803,150,224,'01_20_04.c3d',8,EV,B,M,4,diff,364
1247,1341,94,0.864285271,0.722185071,397,826,66,180,'01_20_05.c3d',8,EV,B,M,5,diff,429
1007,1704,697,1.145460198,1.168608197,554,607,95,147,'01_20_01.c3d',9,EV,B,M,1,diff,53
921,1314,393,1.659676642,1.028787812,459,580,256,254,'01_20_02.c3d',9,EV,B,M,2,diff,121
1504,2225,721,1.421719506,0.958228598,467,663,90,275,'01_20_03.c3d',9,EV,B,M,3,diff,196
1680,2507,827,1.532489918,1.050440607,501,709,272,268,'01_20_04.c3d',9,EV,B,M,4,diff,208
2167,2244,77,0.870817215,0.895108514,1314,1404,281,1,'01_20_05.c3d',9,EV,B,M,5,diff,90
897,1273,376,1.976309115,1.413226177,439,525,249,252,'01_20_01.c3d',10,EV,B,M,1,diff,86
798,1027,229,1.848381538,1.459072889,369,538,175,187,'01_20_02.c3d',10,EV,B,M,2,diff,169
806,973,167,1.774174569,1.424920059,496,648,246,256,'01_20_03.c3d',10,EV,B,M,3,diff,152
893,1166,273,1.329848622,1.13918856,520,742,275,283,'01_20_04.c3d',10,EV,B,M,4,diff,222
1089,1717,628,1.234163215,1.097838014,473,774,278,1,'01_20_05.c3d',10,EV,B,M,5,diff,301
1320,1547,227,1.143339741,0.779048451,675,936,439,1,'01_20_01.c3d',11,EV,B,M,1,diff,261
1406,1566,160,0.602106505,0.680595973,1054,1250,1,1,'01_20_02.c3d',11,EV,B,M,2,diff,196
1259,1582,323,0.829804538,0.717917396,591,959,331,1,'01_20_03.c3d',11,EV,B,M,3,diff,368
1709,1726,17,0.636622187,0.668555082,1167,1229,27,388,'01_20_04.c3d',11,EV,B,M,4,diff,62
2090,3270,1180,0.601961216,0.631356152,1281,1459,8,1,'01_20_05.c3d',11,EV,B,M,5,diff,178
994,1015,21,1.458667646,0.985146901,465,751,234,271,'01_20_01.c3d',12,EV,B,M,1,diff,286
1094,1692,598,1.388096843,0.919784584,485,764,295,298,'01_20_02.c3d',12,EV,B,M,2,diff,279
1190,1396,206,1.170761845,0.762712216,449,865,227,228,'01_20_03.c3d',12,EV,B,M,3,diff,416
955,1808,853,1.368495082,0.993810968,458,713,225,145,'01_20_04.c3d',12,EV,B,M,4,diff,255
775,869,94,1.786187337,1.031975916,432,680,249,203,'01_20_05.c3d',12,EV,B,M,5,diff,248
1025,2202,1177,1.460254364,1.131671717,578,811,292,1,'01_20_01.c3d',13,EV,B,M,1,diff,233
1270,1331,61,1.582214189,1.029863574,598,893,410,408,'01_20_02.c3d',13,EV,B,M,2,diff,295
878,981,103,1.849788944,1.249199799,493,698,208,1,'01_20_03.c3d',13,EV,B,M,3,diff,205
853,971,118,1.502426038,0.968486617,416,704,174,180,'01_20_04.c3d',13,EV,B,M,4,diff,288
934,2282,1348,1.424597395,1.198142759,544,810,1,227,'01_20_05.c3d',13,EV,B,M,5,diff,266
755,818,63,2.103918775,1.691587445,414,582,243,254,'01_20_01.c3d',14,EV,B,M,1,diff,168
699,1403,704,2.234840328,1.927413551,405,532,241,242,'01_20_02.c3d',14,EV,B,M,2,diff,127
878,888,10,1.986917428,1.479479044,452,745,12,308,'01_20_03.c3d',14,EV,B,M,3,diff,293
945,1092,147,1.790513978,1.57490043,361,541,47,174,'01_20_04.c3d',14,EV,B,M,4,diff,180
890,1910,1020,1.751326822,1.365270832,878,593,7,288,'01_20_05.c3d',14,EV,B,M,5,diff,285
860,928,68,1.409724922,1.224536183,475,781,80,1,'01_20_01.c3d',15,EV,B,M,1,diff,306
1020,1487,467,1.275067008,1.033888154,353,502,1,1,'01_20_02.c3d',15,EV,B,M,2,diff,149
906,1370,464,1.37007494,1.138491113,480,646,85,32,'01_20_03.c3d',15,EV,B,M,3,diff,166
856,1101,245,1.369099196,1.267247175,446,708,233,141,'01_20_04.c3d',15,EV,B,M,4,diff,262
1001,1255,254,1.172148868,1.210568393,450,861,2,276,'01_20_05.c3d',15,EV,B,M,5,diff,411
914,1701,787,1.700402848,1.395763457,522,801,298,1,'01_20_01.c3d',16,EV,B,M,1,diff,279
1107,1318,211,1.443415746,1.137764845,471,765,1,284,'01_20_02.c3d',16,EV,B,M,2,diff,294
955,1747,792,1.232447602,1.30541696,401,664,69,238,'01_20_03.c3d',16,EV,B,M,3,diff,263
919,1237,318,1.614579277,1.25878943,449,626,1,128,'01_20_04.c3d',16,EV,B,M,4,diff,177
930,1156,226,1.724813268,1.226086886,481,796,259,237,'01_20_05.c3d',16,EV,B,M,5,diff,315
757,780,23,2.258570653,1.640022626,471,587,291,1,'01_20_01.c3d',17,EV,B,M,1,diff,116
925,989,64,1.821025636,1.502153077,503,664,336,330,'01_20_02.c3d',17,EV,B,M,2,diff,161
626,710,84,2.14376279,1.831602068,405,490,244,255,'01_20_03.c3d',17,EV,B,M,3,diff,85
675,677,2,3.187726087,2.050088774,400,542,267,262,'01_20_04.c3d',17,EV,B,M,4,diff,142
839,969,130,2.297667085,1.462940751,442,541,270,1,'01_20_05.c3d',17,EV,B,M,5,diff,99
1183,1359,176,1.962445625,1.3593346,801,920,1,1,'01_20_01.c3d',18,EV,B,M,1,diff,119
1546,2589,1043,1.120749405,0.897572296,607,914,1,1,'01_20_02.c3d',18,EV,B,M,2,diff,307
847,945,98,1.407761436,1.416524311,542,788,1,1,'01_20_03.c3d',18,EV,B,M,3,diff,246
1003,1035,32,1.408874685,1.440772937,564,808,1,1,'01_20_04.c3d',18,EV,B,M,4,diff,244
1021,1162,141,1.593897647,1.183654383,388,746,1,203,'01_20_05.c3d',18,EV,B,M,5,diff,358
1002,1028,26,1.1543448,0.993856685,515,776,1,278,'01_20_01.c3d',19,EV,B,M,1,diff,261
835,915,80,1.38427823,1.090069101,502,622,1,1,'01_20_02.c3d',19,EV,B,M,2,diff,120
927,1138,211,1.159419768,0.979842174,520,589,180,267,'01_20_03.c3d',19,EV,B,M,3,diff,69
1126,1133,7,1.180046024,1.019646643,555,793,1,310,'01_20_04.c3d',19,EV,B,M,4,diff,238
857,912,55,1.79437488,1.302409396,470,660,238,1,'01_20_05.c3d',19,EV,B,M,5,diff,190
1013,1036,23,1.644064919,1.205354136,592,830,29,363,'01_20_01.c3d',20,EV,B,M,1,diff,238
1084,1537,453,1.562926465,1.215877007,579,839,1,389,'01_20_02.c3d',20,EV,B,M,2,diff,260
1145,1173,28,1.686274513,1.085483062,558,690,366,350,'01_20_03.c3d',20,EV,B,M,3,diff,132
893,1773,880,1.477755378,1.113108387,396,680,221,225,'01_20_04.c3d',20,EV,B,M,4,diff,284
1049,1705,656,1.058117355,0.946672278,477,596,279,225,'01_20_05.c3d',20,EV,B,M,5,diff,119
1035,1086,51,1.604268099,1.015680666,558,801,331,306,'01_20_01.c3d',21,EV,B,M,1,diff,243
977,1672,695,1.412549937,0.908823145,594,823,332,1,'01_20_02.c3d',21,EV,B,M,2,diff,229
1162,1173,11,1.124722918,0.856837631,545,834,298,1,'01_20_03.c3d',21,EV,B,M,3,diff,289
1639,2147,508,0.872390051,0.859611835,483,848,54,296,'01_20_04.c3d',21,EV,B,M,4,diff,365
1252,2512,1260,1.092404101,0.547121583,489,635,289,79,'01_20_05.c3d',21,EV,B,M,5,diff,146
1165,1238,73,1.386898289,1.291959808,578,977,360,397,'01_20_01.c3d',22,EV,B,M,1,diff,399
1211,1650,439,1.416057043,1.266703771,594,985,389,409,'01_20_02.c3d',22,EV,B,M,2,diff,391
1215,2397,1182,0.834422835,1.392733798,642,1010,362,452,'01_20_03.c3d',22,EV,B,M,3,diff,368
1081,1124,43,0.808574679,1.360791335,590,933,158,245,'01_20_04.c3d',22,EV,B,M,4,diff,343
1409,1750,341,0.771841814,1.140748343,831,891,272,348,'01_20_05.c3d',22,EV,B,M,5,diff,60
3902,5291,1389,0.525462192,0.545165402,648,1301,32,470,'01_20_01.c3d',23,EV,B,M,1,diff,653
2323,3075,752,0.679735877,0.734158219,618,1342,44,349,'01_20_02.c3d',23,EV,B,M,2,diff,724
4102,9675,5573,0.625061714,0.447290897,1296,1624,1,1,'01_20_03.c3d',23,EV,B,M,3,diff,328
3255,6427,3172,0.659621541,0.518457103,4634,1722,387,1,'01_20_04.c3d',23,EV,B,M,4,diff,2912
2477,2602,125,0.54334159,0.538571713,908,1402,19,143,'01_20_05.c3d',23,EV,B,M,5,diff,494
933,1255,322,1.48523459,1.028784747,506,821,57,1,'01_20_01.c3d',24,EV,B,M,1,diff,315
997,1077,80,1.773887244,1.004398184,549,875,355,1,'01_20_02.c3d',24,EV,B,M,2,diff,326
976,999,23,1.57292936,1.125872133,556,822,6,1,'01_20_03.c3d',24,EV,B,M,3,diff,266
1083,1149,66,1.326512915,0.903794103,532,812,1,315,'01_20_04.c3d',24,EV,B,M,4,diff,280
957,958,1,1.283141329,1.09580242,451,823,181,169,'01_20_05.c3d',24,EV,B,M,5,diff,372
911,1513,602,1.628602558,1.035565465,502,628,279,276,'01_20_01.c3d',25,EV,B,M,1,diff,126
837,904,67,1.686988848,0.954462991,489,659,250,237,'01_20_02.c3d',25,EV,B,M,2,diff,170
1115,1196,81,1.157987434,0.796813925,588,732,308,297,'01_20_03.c3d',25,EV,B,M,3,diff,144
1027,1072,45,1.245027874,0.919451598,498,707,279,294,'01_20_04.c3d',25,EV,B,M,4,diff,209
1147,1471,324,1.34476483,0.780343852,441,663,182,1,'01_20_05.c3d',25,EV,B,M,5,diff,222
1393,3647,2254,0.723793712,0.648894316,561,881,1,1,'01_20_01.c3d',26,EV,B,M,1,diff,320
1148,3075,1927,1.01023172,0.533453789,586,537,135,102,'01_20_02.c3d',26,EV,B,M,2,diff,49
1202,1435,233,0.801965231,0.681254924,496,722,312,1,'01_20_03.c3d',26,EV,B,M,3,diff,226
1049,1126,77,1.263689992,0.78667792,551,735,322,289,'01_20_04.c3d',26,EV,B,M,4,diff,184
1249,1330,81,1.553285124,0.767460278,773,1025,39,1,'01_20_05.c3d',26,EV,B,M,5,diff,252
1438,1636,198,1.316156842,0.766144151,665,734,411,423,'01_20_01.c3d',27,EV,B,M,1,diff,69
1265,1702,437,1.236516642,1.187362192,656,926,412,402,'01_20_02.c3d',27,EV,B,M,2,diff,270
1308,1892,584,0.981784639,1.078629599,710,1056,1,472,'01_20_03.c3d',27,EV,B,M,3,diff,346
1178,1240,62,1.205027018,0.947476558,599,860,323,296,'01_20_04.c3d',27,EV,B,M,4,diff,261
1566,1750,184,0.796092798,0.978551074,797,1059,1,446,'01_20_05.c3d',27,EV,B,M,5,diff,262
1388,3777,2389,1.113193978,0.958481189,582,2373,1,1765,'01_20_01.c3d',28,EV,B,M,1,diff,1791
1198,1317,119,1.143433705,0.908946419,585,1105,71,360,'01_20_02.c3d',28,EV,B,M,2,diff,520
1245,1594,349,0.957308189,1.003244399,542,992,275,307,'01_20_03.c3d',28,EV,B,M,3,diff,450
1489,1731,242,0.840538448,0.920055506,803,1092,1,1,'01_20_04.c3d',28,EV,B,M,4,diff,289
1081,1239,158,1.030319288,1.14294574,1043,1016,320,1,'01_20_05.c3d',28,EV,B,M,5,diff,27
890,1004,114,1.637710319,1.325972271,511,695,284,279,'01_20_01.c3d',29,EV,B,M,1,diff,184
976,1070,94,1.4250677,1.083613197,438,740,121,1,'01_20_02.c3d',29,EV,B,M,2,diff,302
971,1543,572,1.340207526,1.207289637,527,724,342,1,'01_20_03.c3d',29,EV,B,M,3,diff,197
1023,2146,1123,1.092619779,1.122024709,493,726,254,1,'01_20_04.c3d',29,EV,B,M,4,diff,233
877,1361,484,1.67172823,1.279223802,465,620,28,1,'01_20_05.c3d',29,EV,B,M,5,diff,155
1038,1145,107,1.276769888,0.8502623,578,798,1,337,'01_20_01.c3d',30,EV,B,M,1,diff,220
1006,1452,446,1.143476015,0.827140677,514,791,261,1,'01_20_02.c3d',30,EV,B,M,2,diff,277
1226,1504,278,0.918819483,0.781473065,641,911,1,1,'01_20_03.c3d',30,EV,B,M,3,diff,270
1043,1433,390,0.829787707,0.865315086,486,824,101,222,'01_20_04.c3d',30,EV,B,M,4,diff,338
1009,1121,112,1.025020488,0.768275669,446,650,1,184,'01_20_05.c3d',30,EV,B,M,5,diff,204
1359,1570,211,2.077182578,1.654947036,586,716,365,398,'01_20_01.c3d',31,EV,B,M,1,diff,130
1040,1082,42,2.318407037,1.457670563,528,665,321,316,'01_20_02.c3d',31,EV,B,M,2,diff,137
945,1089,144,1.99620962,1.238982723,543,776,342,334,'01_20_03.c3d',31,EV,B,M,3,diff,233
1057,1092,35,2.134514115,1.359706592,607,751,398,388,'01_20_04.c3d',31,EV,B,M,4,diff,144
892,1047,155,2.099973079,1.270446502,573,795,129,332,'01_20_05.c3d',31,EV,B,M,5,diff,222
879,1669,790,1.58968282,1.236516374,472,723,240,1,'01_20_01.c3d',32,EV,B,M,1,diff,251
1062,2025,963,1.044428693,0.978920619,578,869,282,308,'01_20_02.c3d',32,EV,B,M,2,diff,291
1294,1356,62,1.044630111,1.112476972,626,855,293,336,'01_20_03.c3d',32,EV,B,M,3,diff,229
1038,1083,45,0.973239165,1.128511192,444,961,65,1,'01_20_04.c3d',32,EV,B,M,4,diff,517
1233,1359,126,1.009505249,0.972158062,760,768,257,250,'01_20_05.c3d',32,EV,B,M,5,diff,8
1210,1347,137,1.158197274,0.989934226,607,891,355,323,'01_20_01.c3d',33,EV,B,M,1,diff,284
1176,1191,15,1.17629119,1.018886844,691,1015,53,342,'01_20_02.c3d',33,EV,B,M,2,diff,324
1298,1857,559,1.266294271,0.971340657,608,884,360,320,'01_20_03.c3d',33,EV,B,M,3,diff,276
1172,1222,50,0.975501341,0.978175011,530,852,298,307,'01_20_04.c3d',33,EV,B,M,4,diff,322
1166,1568,402,1.25137992,0.938764512,570,815,1,324,'01_20_05.c3d',33,EV,B,M,5,diff,245
893,989,96,1.870100548,1.290997708,505,664,319,317,'01_20_01.c3d',34,EV,B,M,1,diff,159
941,1155,214,1.379839945,1.055489647,454,572,252,238,'01_20_02.c3d',34,EV,B,M,2,diff,118
985,1172,187,1.035625139,1.046564339,477,685,249,248,'01_20_03.c3d',34,EV,B,M,3,diff,208
1019,1215,196,1.15770731,0.937418523,486,693,25,256,'01_20_04.c3d',34,EV,B,M,4,diff,207
780,2308,1528,1.518742876,1.492627962,533,609,229,235,'01_20_05.c3d',34,EV,B,M,5,diff,76
1003,1054,51,1.831984254,1.058589307,459,754,261,264,'01_20_01.c3d',35,EV,B,M,1,diff,295
1191,1888,697,1.511078045,0.805044626,482,824,302,1,'01_20_02.c3d',35,EV,B,M,2,diff,342
1071,1099,28,1.532641676,1.052909336,480,810,1,324,'01_20_03.c3d',35,EV,B,M,3,diff,330
690,694,4,1.255006913,1.020944854,101,506,1,1,'01_20_04.c3d',35,EV,B,M,4,diff,405
879,1009,130,1.70621383,0.949791284,418,710,103,135,'01_20_05.c3d',35,EV,B,M,5,diff,292
1015,1129,114,0.654933015,0.985589626,423,737,209,258,'01_22_01.c3d',1,EV,L,E,1,diff,314
596,1111,515,0.932868828,1.040285202,446,827,243,249,'01_22_02.c3d',1,EV,L,E,2,diff,381
153,2375,2222,2.234552942,1.462676535,199,1,1,1,'01_22_03.c3d',1,EV,L,E,3,diff,198
729,1408,679,0.80160835,0.804142759,614,1176,1,306,'01_22_04.c3d',1,EV,L,E,4,diff,562
613,2930,2317,1.180480979,1.127061365,512,910,321,1,'01_22_05.c3d',1,EV,L,E,5,diff,398
1276,2181,905,0.662485957,0.776033984,595,1210,69,17,'01_22_01.c3d',2,EV,L,E,1,diff,615
673,2500,1827,1.02052136,1.154056407,545,963,1,294,'01_22_02.c3d',2,EV,L,E,2,diff,418
1090,2187,1097,0.701494902,0.739899735,604,952,1,1,'01_22_03.c3d',2,EV,L,E,3,diff,348
702,1177,475,0.829588532,1.126340497,482,1046,1,283,'01_22_04.c3d',2,EV,L,E,4,diff,564
692,1387,695,1.078322988,1.102641543,516,939,275,245,'01_22_05.c3d',2,EV,L,E,5,diff,423
458,1305,847,1.42303913,1.56898391,389,695,1,1,'01_22_01.c3d',3,EV,L,E,1,diff,306
499,1625,1126,1.346032165,1.152522736,441,807,252,1,'01_22_02.c3d',3,EV,L,E,2,diff,366
467,735,268,1.021256731,1.656785418,428,648,1,242,'01_22_03.c3d',3,EV,L,E,3,diff,220
393,721,328,1.39212077,1.659087741,339,630,73,1,'01_22_04.c3d',3,EV,L,E,4,diff,291
972,976,4,0.967675738,1.277479727,457,849,292,1,'01_22_05.c3d',3,EV,L,E,5,diff,392
766,1085,319,1.442964945,0.99888488,553,560,371,1,'01_22_01.c3d',4,EV,L,E,1,diff,7
850,1028,178,1.293680829,1.216859009,638,831,73,1,'01_22_02.c3d',4,EV,L,E,2,diff,193
862,1886,1024,0.759544874,1.067213397,537,977,124,347,'01_22_03.c3d',4,EV,L,E,3,diff,440
792,1008,216,0.941979228,0.885633712,500,877,265,1,'01_22_04.c3d',4,EV,L,E,4,diff,377
747,1056,309,0.790922409,1.107922635,545,925,1,1,'01_22_05.c3d',4,EV,L,E,5,diff,380
421,1267,846,2.177267083,2.275750895,384,478,253,258,'01_22_01.c3d',5,EV,L,E,1,diff,94
545,1486,941,2.600225364,2.051522917,418,488,302,1,'01_22_02.c3d',5,EV,L,E,2,diff,70
547,678,131,2.352720199,1.853968363,400,520,253,1,'01_22_03.c3d',5,EV,L,E,3,diff,120
415,732,317,2.32373695,2.228915212,385,459,264,262,'01_22_04.c3d',5,EV,L,E,4,diff,74
560,739,179,1.43181322,1.77890031,473,606,103,287,'01_22_05.c3d',5,EV,L,E,5,diff,133
592,1464,872,1.272365182,1.531342066,519,1308,1,777,'01_22_01.c3d',6,EV,L,E,1,diff,789
652,1528,876,0.957381445,1.099831685,519,988,1,1,'01_22_02.c3d',6,EV,L,E,2,diff,469
841,1543,702,1.012336806,1.156448971,732,1384,1,1,'01_22_03.c3d',6,EV,L,E,3,diff,652
668,1069,401,1.125374641,0.948396854,472,789,1,1,'01_22_04.c3d',6,EV,L,E,4,diff,317
708,1369,661,0.750302845,1.356181184,583,870,335,1,'01_22_05.c3d',6,EV,L,E,5,diff,287
540,1724,1184,1.193989211,0.874655712,441,635,251,1,'01_22_01.c3d',7,EV,L,E,1,diff,194
594,2103,1509,1.005510024,0.774876261,452,790,100,1,'01_22_02.c3d',7,EV,L,E,2,diff,338
600,932,332,0.91880917,0.984886957,464,739,1,289,'01_22_03.c3d',7,EV,L,E,3,diff,275
517,823,306,1.353641474,0.882063487,331,522,126,1,'01_22_04.c3d',7,EV,L,E,4,diff,191
422,2374,1952,1.000689027,0.812298868,305,532,97,2,'01_22_05.c3d',7,EV,L,E,5,diff,227
1023,1929,906,0.808909386,1.193610291,555,742,61,355,'01_22_01.c3d',8,EV,L,E,1,diff,187
1016,1088,72,0.985420164,0.989628329,465,783,266,281,'01_22_02.c3d',8,EV,L,E,2,diff,318
952,1018,66,0.844705887,0.953180697,401,745,48,199,'01_22_03.c3d',8,EV,L,E,3,diff,344
1254,1290,36,0.592007346,0.765837104,483,957,253,301,'01_22_04.c3d',8,EV,L,E,4,diff,474
443,1519,1076,0.877308828,0.956174617,269,744,17,1,'01_22_05.c3d',8,EV,L,E,5,diff,475
1338,1678,340,0.448649925,1.059539788,575,546,235,244,'01_22_01.c3d',9,EV,L,E,1,diff,29
839,904,65,0.835738516,1.085366919,530,663,265,265,'01_22_02.c3d',9,EV,L,E,2,diff,133
796,915,119,0.758438042,1.116886133,411,560,247,170,'01_22_03.c3d',9,EV,L,E,3,diff,149
1063,1270,207,0.664054073,0.8343247,458,611,144,232,'01_22_04.c3d',9,EV,L,E,4,diff,153
846,1082,236,0.833236713,0.840010984,513,664,271,256,'01_22_05.c3d',9,EV,L,E,5,diff,151
668,1525,857,0.792097111,2.454232786,421,621,26,290,'01_22_01.c3d',10,EV,L,E,1,diff,200
533,850,317,1.44675341,1.64296388,433,554,292,265,'01_22_02.c3d',10,EV,L,E,2,diff,121
883,1244,361,0.55696196,1.460403392,424,760,243,257,'01_22_03.c3d',10,EV,L,E,3,diff,336
786,3574,2788,0.920252081,1.728749506,411,627,223,78,'01_22_04.c3d',10,EV,L,E,4,diff,216
528,1157,629,1.161743129,1.614445631,346,526,120,4,'01_22_05.c3d',10,EV,L,E,5,diff,180
1295,1461,166,0.498047195,0.739567259,640,1132,7,409,'01_22_01.c3d',11,EV,L,E,1,diff,492
1205,2092,887,0.483903259,0.58823113,616,966,313,327,'01_22_02.c3d',11,EV,L,E,2,diff,350
1332,1638,306,0.492597801,0.703407147,660,1091,1,394,'01_22_03.c3d',11,EV,L,E,3,diff,431
1148,2118,970,0.628831434,0.628643218,707,1002,1,1,'01_22_04.c3d',11,EV,L,E,4,diff,295
1234,1998,764,0.656852874,0.547684505,620,1059,1,308,'01_22_05.c3d',11,EV,L,E,5,diff,439
591,948,357,0.953530315,1.23189733,470,760,288,299,'01_22_01.c3d',12,EV,L,E,1,diff,290
516,1024,508,1.205506512,1.07934299,459,726,276,274,'01_22_02.c3d',12,EV,L,E,2,diff,267
594,1090,496,1.105162444,1.040287267,493,776,316,328,'01_22_03.c3d',12,EV,L,E,3,diff,283
558,1011,453,1.343796394,1.214847581,478,764,296,306,'01_22_04.c3d',12,EV,L,E,4,diff,286
503,861,358,0.859698876,1.161777415,400,581,96,120,'01_22_05.c3d',12,EV,L,E,5,diff,181
666,1791,1125,0.894140975,1.130435849,535,848,21,1,'01_22_01.c3d',13,EV,L,E,1,diff,313
535,994,459,1.064823392,1.06361678,453,752,179,270,'01_22_02.c3d',13,EV,L,E,2,diff,299
490,894,404,1.134186407,1.159184833,426,664,1,1,'01_22_03.c3d',13,EV,L,E,3,diff,238
494,904,410,1.262906761,1.11579021,439,718,218,1,'01_22_04.c3d',13,EV,L,E,4,diff,279
990,1103,113,0.788022914,1.144359129,471,725,1,262,'01_22_05.c3d',13,EV,L,E,5,diff,254
897,1385,488,1.292405269,1.64033964,450,725,20,284,'01_22_01.c3d',14,EV,L,E,1,diff,275
488,693,205,1.512232153,2.191996973,430,590,1,1,'01_22_02.c3d',14,EV,L,E,2,diff,160
481,813,332,1.291153207,1.595181147,380,557,1,1,'01_22_03.c3d',14,EV,L,E,3,diff,177
472,670,198,1.285359903,1.984509074,345,531,183,220,'01_22_04.c3d',14,EV,L,E,4,diff,186
425,736,311,1.483103389,1.744533315,356,573,1,133,'01_22_05.c3d',14,EV,L,E,5,diff,217
839,893,54,1.113298186,1.270769877,454,751,271,270,'01_22_01.c3d',15,EV,L,E,1,diff,297
521,798,277,1.325309624,1.703999863,446,666,263,279,'01_22_02.c3d',15,EV,L,E,2,diff,220
540,868,328,1.302819439,1.489890018,456,667,259,261,'01_22_03.c3d',15,EV,L,E,3,diff,211
413,901,488,1.096595147,1.167692684,355,621,1,1,'01_22_04.c3d',15,EV,L,E,4,diff,266
546,1207,661,1.226136465,1.130302475,416,735,228,247,'01_22_05.c3d',15,EV,L,E,5,diff,319
871,1080,209,0.883618894,1.039084721,449,729,264,301,'01_22_01.c3d',16,EV,L,E,1,diff,280
538,1173,635,1.340844858,1.716866147,426,624,28,1,'01_22_02.c3d',16,EV,L,E,2,diff,198
1448,1857,409,1.023357547,1.351286779,383,680,167,188,'01_22_03.c3d',16,EV,L,E,3,diff,297
750,846,96,0.699299155,1.196200333,117,611,1,1,'01_22_04.c3d',16,EV,L,E,4,diff,494
1141,1755,614,0.753688377,1.513812609,414,560,1,234,'01_22_05.c3d',16,EV,L,E,5,diff,146
627,794,167,1.966678513,1.693856904,430,593,279,293,'01_22_01.c3d',17,EV,L,E,1,diff,163
480,793,313,1.779633741,1.650182613,409,556,1,1,'01_22_02.c3d',17,EV,L,E,2,diff,147
566,1210,644,2.83936249,2.101090053,405,445,280,282,'01_22_03.c3d',17,EV,L,E,3,diff,40
484,733,249,2.127022117,1.400797808,372,602,249,241,'01_22_04.c3d',17,EV,L,E,4,diff,230
656,698,42,1.92884717,2.116451164,415,580,289,290,'01_22_05.c3d',17,EV,L,E,5,diff,165
593,861,268,1.235139663,1.549032141,501,689,33,318,'01_22_01.c3d',18,EV,L,E,1,diff,188
463,1244,781,1.206703399,1.893049473,449,589,41,279,'01_22_02.c3d',18,EV,L,E,2,diff,140
484,988,504,1.190690268,1.534157419,465,526,1,1,'01_22_03.c3d',18,EV,L,E,3,diff,61
466,999,533,0.956018392,1.514231018,422,543,1,1,'01_22_04.c3d',18,EV,L,E,4,diff,121
680,1212,532,1.018431366,1.505038062,646,789,1,411,'01_22_05.c3d',18,EV,L,E,5,diff,143
1027,1112,85,0.888608208,1.001637407,498,611,1,319,'01_22_01.c3d',19,EV,L,E,1,diff,113
610,926,316,0.928340976,1.256703903,457,697,263,259,'01_22_02.c3d',19,EV,L,E,2,diff,240
600,1009,409,0.827853165,1.276063153,469,646,1,1,'01_22_03.c3d',19,EV,L,E,3,diff,177
870,929,59,0.804689097,1.308593586,449,647,1,255,'01_22_04.c3d',19,EV,L,E,4,diff,198
545,938,393,1.04831307,1.427373162,469,634,253,242,'01_22_05.c3d',19,EV,L,E,5,diff,165
921,947,26,1.163328113,1.153894387,435,600,34,19,'01_22_01.c3d',20,EV,L,E,1,diff,165
583,1338,755,1.29565455,1.193691076,462,634,273,268,'01_22_02.c3d',20,EV,L,E,2,diff,172
830,922,92,1.128235374,1.03566099,452,586,1,281,'01_22_03.c3d',20,EV,L,E,3,diff,134
958,998,40,0.889947372,1.106291094,454,763,293,271,'01_22_04.c3d',20,EV,L,E,4,diff,309
921,949,28,1.129615987,1.087958262,476,613,285,1,'01_22_05.c3d',20,EV,L,E,5,diff,137
812,1443,631,0.716803019,1.031913106,472,753,53,1,'01_22_01.c3d',21,EV,L,E,1,diff,281
660,2149,1489,0.885202074,1.07893741,506,704,52,1,'01_22_02.c3d',21,EV,L,E,2,diff,198
586,1027,441,1.074914849,0.918846034,453,780,1,255,'01_22_03.c3d',21,EV,L,E,3,diff,327
574,1079,505,1.126459575,0.836587788,481,789,1,1,'01_22_04.c3d',21,EV,L,E,4,diff,308
582,1673,1091,1.006113444,0.747006814,469,769,1,1,'01_22_05.c3d',21,EV,L,E,5,diff,300
643,1279,636,1.042098139,1.249480577,509,1096,1,322,'01_22_01.c3d',22,EV,L,E,1,diff,587
757,1552,795,0.937458609,1.147247941,612,1431,338,404,'01_22_02.c3d',22,EV,L,E,2,diff,819
930,1158,228,0.817409355,1.274551924,464,839,285,1,'01_22_03.c3d',22,EV,L,E,3,diff,375
706,1260,554,0.937813488,1.107518387,609,904,304,343,'01_22_04.c3d',22,EV,L,E,4,diff,295
699,1559,860,0.888497436,1.098577634,576,1406,302,343,'01_22_05.c3d',22,EV,L,E,5,diff,830
1732,2792,1060,0.712118741,0.650076271,516,1395,290,317,'01_22_01.c3d',23,EV,L,E,1,diff,879
996,3514,2518,0.453341833,0.563303536,922,1920,63,48,'01_22_02.c3d',23,EV,L,E,2,diff,998
1667,1744,77,0.37953788,0.670153119,600,1462,16,302,'01_22_03.c3d',23,EV,L,E,3,diff,862
1886,3372,1486,0.478700881,0.681428348,494,1262,272,269,'01_22_04.c3d',23,EV,L,E,4,diff,768
1558,3196,1638,0.375157237,0.503178398,511,934,260,280,'01_22_05.c3d',23,EV,L,E,5,diff,423
941,1047,106,0.867351921,1.147849804,535,749,1,369,'01_22_01.c3d',24,EV,L,E,1,diff,214
552,955,403,1.077938998,1.088001238,411,623,237,253,'01_22_02.c3d',24,EV,L,E,2,diff,212
441,1377,936,1.537887975,1.143681512,399,581,198,1,'01_22_03.c3d',24,EV,L,E,3,diff,182
485,771,286,1.090811688,1.389043102,377,659,1,209,'01_22_04.c3d',24,EV,L,E,4,diff,282
980,982,2,0.590800077,0.916465361,394,736,1,193,'01_22_05.c3d',24,EV,L,E,5,diff,342
540,948,408,1.412384067,1.425880538,482,618,1,332,'01_22_01.c3d',25,EV,L,E,1,diff,136
601,1006,405,1.02958412,0.976689334,497,750,265,282,'01_22_02.c3d',25,EV,L,E,2,diff,253
863,1070,207,0.701158859,0.861602043,479,754,244,199,'01_22_03.c3d',25,EV,L,E,3,diff,275
709,1197,488,0.821284776,0.824770554,668,788,359,167,'01_22_04.c3d',25,EV,L,E,4,diff,120
799,974,175,0.970731096,0.869925713,413,755,223,229,'01_22_05.c3d',25,EV,L,E,5,diff,342
2288,2794,506,0.630189333,0.498273781,961,1324,1,1,'01_22_01.c3d',26,EV,L,E,1,diff,363
1926,2161,235,0.784014489,0.853414983,444,567,254,264,'01_22_02.c3d',26,EV,L,E,2,diff,123
692,2768,2076,0.731211102,0.879238638,529,665,155,321,'01_22_03.c3d',26,EV,L,E,3,diff,136
1101,2279,1178,0.564264494,0.70777572,513,685,29,307,'01_22_04.c3d',26,EV,L,E,4,diff,172
1239,1305,66,0.753328288,0.754684918,682,1140,59,1,'01_22_05.c3d',26,EV,L,E,5,diff,458
1157,1202,45,0.936202619,1.192160528,733,912,1,456,'01_22_01.c3d',27,EV,L,E,1,diff,179
747,1232,485,1.413577708,1.159822715,679,871,1,445,'01_22_02.c3d',27,EV,L,E,2,diff,192
705,1261,556,0.887568225,1.061304136,533,772,296,309,'01_22_03.c3d',27,EV,L,E,3,diff,239
849,1226,377,0.868001287,1.153176718,627,845,383,405,'01_22_04.c3d',27,EV,L,E,4,diff,218
1251,1508,257,0.777213667,0.976801688,588,1347,346,400,'01_22_05.c3d',27,EV,L,E,5,diff,759
1899,3187,1288,0.347743927,0.743562143,2424,1453,1,565,'01_22_01.c3d',28,EV,L,E,1,diff,971
1116,1677,561,0.62946838,0.666142983,722,1095,1,507,'01_22_02.c3d',28,EV,L,E,2,diff,373
591,1153,562,1.129862577,0.933812073,472,831,247,267,'01_22_03.c3d',28,EV,L,E,3,diff,359
713,1374,661,0.952960293,0.891632908,566,846,322,1,'01_22_04.c3d',28,EV,L,E,4,diff,280
1023,1841,818,0.622334792,0.607695067,508,1191,4,1,'01_22_05.c3d',28,EV,L,E,5,diff,683
551,770,219,0.913523465,1.47433245,426,606,1,1,'01_22_01.c3d',29,EV,L,E,1,diff,180
1088,1873,785,0.879003087,1.0098584,579,913,1,1,'01_22_02.c3d',29,EV,L,E,2,diff,334
705,1207,502,0.966307109,1.324343424,617,855,1,1,'01_22_03.c3d',29,EV,L,E,3,diff,238
578,1076,498,0.976014401,1.289212015,511,684,277,1,'01_22_04.c3d',29,EV,L,E,4,diff,173
523,996,473,0.984272676,1.175328557,414,655,28,197,'01_22_05.c3d',29,EV,L,E,5,diff,241
501,762,261,1.086540749,1.234856492,422,572,203,1,'01_22_01.c3d',30,EV,L,E,1,diff,150
580,892,312,0.698489306,0.873628389,436,794,20,19,'01_22_02.c3d',30,EV,L,E,2,diff,358
556,984,428,1.093461574,0.90064412,477,720,273,273,'01_22_03.c3d',30,EV,L,E,3,diff,243
655,1007,352,0.750326039,0.860331228,540,719,271,280,'01_22_04.c3d',30,EV,L,E,4,diff,179
635,999,364,0.583251055,0.807352252,433,867,43,198,'01_22_05.c3d',30,EV,L,E,5,diff,434
742,1277,535,1.557604215,1.382408497,525,636,313,296,'01_22_01.c3d',31,EV,L,E,1,diff,111
626,1069,443,1.385459351,1.404355668,506,606,1,326,'01_22_02.c3d',31,EV,L,E,2,diff,100
643,1539,896,1.653755317,1.153571113,553,571,361,368,'01_22_03.c3d',31,EV,L,E,3,diff,18
562,1469,907,1.727679202,1.421898545,481,660,312,310,'01_22_04.c3d',31,EV,L,E,4,diff,179
1194,1819,625,1.141495779,1.066466746,474,623,283,290,'01_22_05.c3d',31,EV,L,E,5,diff,149
629,1652,1023,1.346247817,1.101374939,535,728,334,350,'01_22_01.c3d',32,EV,L,E,1,diff,193
751,894,143,0.99869642,1.405894475,567,762,364,1,'01_22_02.c3d',32,EV,L,E,2,diff,195
550,1087,537,1.271655285,1.519013756,473,634,1,1,'01_22_03.c3d',32,EV,L,E,3,diff,161
670,1002,332,0.911304449,1.248501241,547,732,295,294,'01_22_04.c3d',32,EV,L,E,4,diff,185
1000,1227,227,0.669388125,0.828337208,536,884,293,285,'01_22_05.c3d',32,EV,L,E,5,diff,348
1117,1361,244,0.503840719,0.831353918,536,1046,307,333,'01_22_01.c3d',33,EV,L,E,1,diff,510
898,1374,476,0.679222072,0.911152008,712,904,1,1,'01_22_02.c3d',33,EV,L,E,2,diff,192
1069,1308,239,0.752748568,1.102808355,657,866,112,399,'01_22_03.c3d',33,EV,L,E,3,diff,209
974,1126,152,0.756721146,1.049299218,573,871,343,333,'01_22_04.c3d',33,EV,L,E,4,diff,298
936,1424,488,0.662892132,0.848705097,693,883,382,346,'01_22_05.c3d',33,EV,L,E,5,diff,190
951,2290,1339,0.584256619,1.165224175,715,733,349,293,'01_22_01.c3d',34,EV,L,E,1,diff,18
609,1047,438,0.988741746,1.145388476,546,714,331,341,'01_22_02.c3d',34,EV,L,E,2,diff,168
544,989,445,0.977357089,0.928567116,415,597,14,243,'01_22_03.c3d',34,EV,L,E,3,diff,182
465,899,434,1.120091706,0.911540046,406,554,22,1,'01_22_04.c3d',34,EV,L,E,4,diff,148
548,870,322,0.853516912,1.122653662,420,590,59,1,'01_22_05.c3d',34,EV,L,E,5,diff,170
632,964,332,1.135379819,1.185472742,467,735,275,279,'01_22_01.c3d',35,EV,L,E,1,diff,268
560,1015,455,1.153687506,1.075292448,478,660,1,259,'01_22_02.c3d',35,EV,L,E,2,diff,182
339,1878,1539,1.460008749,1.121603706,310,540,33,1,'01_22_03.c3d',35,EV,L,E,3,diff,230
323,775,452,1.166108056,1.02434511,219,528,1,1,'01_22_04.c3d',35,EV,L,E,4,diff,309
583,1016,433,0.559445789,0.933805786,476,686,1,1,'01_22_05.c3d',35,EV,L,E,5,diff,210
776,1551,775,1.106383308,0.653475108,538,730,82,237,'01_25_01.c3d',1,EV,R,E,1,diff,192
1085,1139,54,1.275732025,0.548658849,633,523,256,1,'01_25_02.c3d',1,EV,R,E,2,diff,110
959,1021,62,1.221806901,0.461038127,524,725,264,254,'01_25_03.c3d',1,EV,R,E,3,diff,201
799,1477,678,1.149861425,0.610123784,492,645,237,232,'01_25_04.c3d',1,EV,R,E,4,diff,153
862,999,137,1.277503655,0.578668154,502,745,253,229,'01_25_05.c3d',1,EV,R,E,5,diff,243
992,1294,302,1.128114427,0.585484144,599,782,366,1,'01_25_01.c3d',2,EV,R,E,1,diff,183
862,2775,1913,1.073976873,0.610504564,519,679,56,265,'01_25_02.c3d',2,EV,R,E,2,diff,160
794,1003,209,1.049610836,0.677471884,509,579,91,1,'01_25_03.c3d',2,EV,R,E,3,diff,70
835,1718,883,1.105173056,0.73058421,617,671,171,1,'01_25_04.c3d',2,EV,R,E,4,diff,54
771,1812,1041,1.510357138,0.881763436,605,655,364,1,'01_25_05.c3d',2,EV,R,E,5,diff,50
671,1127,456,1.636091838,0.838740994,441,589,299,324,'01_25_01.c3d',3,EV,R,E,1,diff,148
675,801,126,1.232319165,0.91571265,542,360,84,1,'01_25_02.c3d',3,EV,R,E,2,diff,182
735,946,211,1.256202659,0.820070647,577,627,30,51,'01_25_03.c3d',3,EV,R,E,3,diff,50
664,999,335,1.587361059,0.771346529,536,484,1,260,'01_25_04.c3d',3,EV,R,E,4,diff,52
793,827,34,1.437632502,0.770420888,430,381,181,145,'01_25_05.c3d',3,EV,R,E,5,diff,49
1195,1415,220,0.928675574,0.41663522,794,1080,1,1,'01_25_01.c3d',4,EV,R,E,1,diff,286
625,1205,580,1.777387741,0.82666609,525,503,312,259,'01_25_02.c3d',4,EV,R,E,2,diff,22
862,884,22,1.071805674,0.564978506,507,712,1,272,'01_25_03.c3d',4,EV,R,E,3,diff,205
969,985,16,1.341181126,0.484298951,526,859,26,1,'01_25_04.c3d',4,EV,R,E,4,diff,333
750,871,121,1.111351114,0.573246098,459,630,1,124,'01_25_05.c3d',4,EV,R,E,5,diff,171
545,968,423,2.998497753,1.060684071,445,527,309,1,'01_25_01.c3d',5,EV,R,E,1,diff,82
662,809,147,1.973144542,0.714019863,432,488,1,1,'01_25_02.c3d',5,EV,R,E,2,diff,56
655,1295,640,2.120844337,0.908877016,523,595,364,287,'01_25_03.c3d',5,EV,R,E,3,diff,72
627,956,329,2.247369324,1.109268502,465,545,333,1,'01_25_04.c3d',5,EV,R,E,4,diff,80
539,1304,765,2.145623164,1.185429397,463,476,273,265,'01_25_05.c3d',5,EV,R,E,5,diff,13
787,1407,620,1.134170474,0.677239249,957,627,274,1,'01_25_01.c3d',6,EV,R,E,1,diff,330
766,1264,498,0.979562766,0.783812988,1214,661,413,398,'01_25_02.c3d',6,EV,R,E,2,diff,553
733,1328,595,1.277665735,0.664728345,970,592,280,26,'01_25_03.c3d',6,EV,R,E,3,diff,378
717,1088,371,0.997672834,0.787639497,726,625,1,1,'01_25_04.c3d',6,EV,R,E,4,diff,101
642,1522,880,0.703226566,0.807554621,1005,543,1,290,'01_25_05.c3d',6,EV,R,E,5,diff,462
1001,2029,1028,0.576606286,0.387451658,641,870,1,1,'01_25_01.c3d',7,EV,R,E,1,diff,229
1163,1819,656,0.773322262,0.338458231,645,941,383,1,'01_25_02.c3d',7,EV,R,E,2,diff,296
783,979,196,1.179201803,0.457047547,456,561,17,203,'01_25_03.c3d',7,EV,R,E,3,diff,105
471,1395,924,1.409207437,0.491057409,436,333,13,1,'01_25_04.c3d',7,EV,R,E,4,diff,103
837,995,158,1.339190322,0.425397106,526,495,269,1,'01_25_05.c3d',7,EV,R,E,5,diff,31
896,1908,1012,1.292723163,0.701237656,674,777,1,1,'01_25_01.c3d',8,EV,R,E,1,diff,103
693,1482,789,1.24839866,0.712954982,487,597,24,250,'01_25_02.c3d',8,EV,R,E,2,diff,110
822,1927,1105,1.064137816,0.535590657,511,797,1,243,'01_25_03.c3d',8,EV,R,E,3,diff,286
887,1268,381,1.06513011,0.630586258,635,733,1,362,'01_25_04.c3d',8,EV,R,E,4,diff,98
910,1198,288,0.997018,0.48725895,535,692,265,259,'01_25_05.c3d',8,EV,R,E,5,diff,157
587,1476,889,0.935541097,0.965057178,610,531,289,276,'01_25_01.c3d',9,EV,R,E,1,diff,79
744,1463,719,1.294433023,0.668223766,572,494,1,303,'01_25_02.c3d',9,EV,R,E,2,diff,78
786,1552,766,1.09242593,0.530643495,410,489,235,1,'01_25_03.c3d',9,EV,R,E,3,diff,79
626,1384,758,1.497649662,0.676547291,446,461,259,1,'01_25_04.c3d',9,EV,R,E,4,diff,15
912,2175,1263,0.882347384,0.453151153,1406,383,275,1,'01_25_05.c3d',9,EV,R,E,5,diff,1023
703,1012,309,1.859128981,0.939727724,478,574,279,1,'01_25_01.c3d',10,EV,R,E,1,diff,96
701,1320,619,1.372880611,1.06457434,547,540,294,278,'01_25_02.c3d',10,EV,R,E,2,diff,7
666,1352,686,1.645010901,0.867629851,489,536,281,274,'01_25_03.c3d',10,EV,R,E,3,diff,47
700,1204,504,1.311073724,0.930370102,524,557,282,275,'01_25_04.c3d',10,EV,R,E,4,diff,33
693,935,242,1.501475787,1.352812746,459,1,1,1,'01_25_05.c3d',10,EV,R,E,5,diff,458
1278,2020,742,0.679157716,0.468607486,1257,1182,1,1,'01_25_01.c3d',11,EV,R,E,1,diff,75
1188,1549,361,0.682168618,0.386957135,1064,1012,1,1,'01_25_02.c3d',11,EV,R,E,2,diff,52
1132,1635,503,0.893838525,0.407004484,1126,960,49,1,'01_25_03.c3d',11,EV,R,E,3,diff,166
1075,1560,485,0.597703593,0.434809403,632,798,1,84,'01_25_04.c3d',11,EV,R,E,4,diff,166
1036,1776,740,0.534913963,0.378525537,581,720,285,1,'01_25_05.c3d',11,EV,R,E,5,diff,139
897,1348,451,1.061562643,0.45313926,481,513,284,39,'01_25_01.c3d',12,EV,R,E,1,diff,32
669,1219,550,1.529294322,0.609503914,442,650,261,1,'01_25_02.c3d',12,EV,R,E,2,diff,208
598,1420,822,1.796598776,0.718561216,531,540,274,1,'01_25_03.c3d',12,EV,R,E,3,diff,9
668,770,102,1.852019374,0.635822727,445,511,245,245,'01_25_04.c3d',12,EV,R,E,4,diff,66
754,1806,1052,1.259891024,0.534987843,461,504,257,94,'01_25_05.c3d',12,EV,R,E,5,diff,43
795,830,35,1.670136705,0.704496781,532,767,1,257,'01_25_01.c3d',13,EV,R,E,1,diff,235
1143,1288,145,1.67815947,0.717543928,500,548,35,1,'01_25_02.c3d',13,EV,R,E,2,diff,48
736,793,57,1.508119093,0.681574857,502,654,260,288,'01_25_03.c3d',13,EV,R,E,3,diff,152
774,846,72,1.928394212,0.589398232,478,632,271,1,'01_25_04.c3d',13,EV,R,E,4,diff,154
768,1411,643,1.49023327,0.729694058,518,624,63,1,'01_25_05.c3d',13,EV,R,E,5,diff,106
1140,1775,635,1.849655479,0.88146802,984,1056,1,256,'01_25_01.c3d',14,EV,R,E,1,diff,72
860,1775,915,1.742249447,0.906192613,470,610,1,1,'01_25_02.c3d',14,EV,R,E,2,diff,140
579,1468,889,1.878335308,1.035861846,455,526,1,1,'01_25_03.c3d',14,EV,R,E,3,diff,71
715,913,198,2.044062386,0.875330771,410,459,216,1,'01_25_04.c3d',14,EV,R,E,4,diff,49
668,1302,634,1.295838831,0.845928298,512,579,231,237,'01_25_05.c3d',14,EV,R,E,5,diff,67
633,665,32,1.544696009,0.765837604,385,347,24,67,'01_25_01.c3d',15,EV,R,E,1,diff,38
735,1101,366,1.330362289,0.583239527,492,440,263,245,'01_25_02.c3d',15,EV,R,E,2,diff,52
784,867,83,1.48927455,0.670905279,483,656,245,269,'01_25_03.c3d',15,EV,R,E,3,diff,173
610,1709,1099,1.701682603,0.783984575,470,464,178,1,'01_25_04.c3d',15,EV,R,E,4,diff,6
819,1134,315,1.025575555,0.568949125,508,607,52,277,'01_25_05.c3d',15,EV,R,E,5,diff,99
725,863,138,1.510584812,0.726194834,540,560,269,1,'01_25_01.c3d',16,EV,R,E,1,diff,20
490,909,419,1.242151983,0.685138244,405,367,1,1,'01_25_02.c3d',16,EV,R,E,2,diff,38
780,1422,642,1.265250158,0.565511622,482,629,253,1,'01_25_03.c3d',16,EV,R,E,3,diff,147
627,1002,375,0.858458794,0.533154473,947,278,1,1,'01_25_04.c3d',16,EV,R,E,4,diff,669
581,930,349,1.567231426,0.777194351,386,428,181,1,'01_25_05.c3d',16,EV,R,E,5,diff,42
603,877,274,3.773026611,1.246144411,373,388,226,215,'01_25_01.c3d',17,EV,R,E,1,diff,15
792,894,102,3.206819143,1.170620557,429,392,296,44,'01_25_02.c3d',17,EV,R,E,2,diff,37
476,745,269,3.172436482,1.197439792,403,406,248,232,'01_25_03.c3d',17,EV,R,E,3,diff,3
626,712,86,2.823193493,1.180606667,480,452,333,318,'01_25_04.c3d',17,EV,R,E,4,diff,28
561,1204,643,2.966920709,1.064627719,444,393,299,281,'01_25_05.c3d',17,EV,R,E,5,diff,51
874,1362,488,2.007493599,1.167370014,508,623,1,275,'01_25_01.c3d',18,EV,R,E,1,diff,115
831,839,8,1.365975423,0.665065722,468,806,129,208,'01_25_02.c3d',18,EV,R,E,2,diff,338
800,850,50,1.442654055,0.77875571,484,800,1,243,'01_25_03.c3d',18,EV,R,E,3,diff,316
783,1350,567,1.628070493,0.744765305,459,530,1,227,'01_25_04.c3d',18,EV,R,E,4,diff,71
661,1352,691,1.567338442,0.841882905,482,455,1,1,'01_25_05.c3d',18,EV,R,E,5,diff,27
827,1432,605,0.953444194,0.643270058,580,723,14,1,'01_25_01.c3d',19,EV,R,E,1,diff,143
833,842,9,1.301102525,0.656333817,480,621,1,227,'01_25_02.c3d',19,EV,R,E,2,diff,141
819,1104,285,1.443722932,0.663952361,551,651,124,1,'01_25_03.c3d',19,EV,R,E,3,diff,100
629,985,356,1.428273274,0.975404444,480,565,264,254,'01_25_04.c3d',19,EV,R,E,4,diff,85
743,978,235,1.464927835,0.863260899,603,710,62,1,'01_25_05.c3d',19,EV,R,E,5,diff,107
791,1050,259,1.577637036,0.696033256,545,624,306,271,'01_25_01.c3d',20,EV,R,E,1,diff,79
737,1193,456,1.214716046,0.761432613,541,630,325,1,'01_25_02.c3d',20,EV,R,E,2,diff,89
725,1454,729,1.479963191,0.742895381,552,638,323,309,'01_25_03.c3d',20,EV,R,E,3,diff,86
759,1284,525,1.715463963,0.637208376,501,623,340,1,'01_25_04.c3d',20,EV,R,E,4,diff,122
776,1251,475,0.947072028,0.648495463,478,513,259,231,'01_25_05.c3d',20,EV,R,E,5,diff,35
913,1554,641,1.291007515,0.589881648,628,891,13,1,'01_25_01.c3d',21,EV,R,E,1,diff,263
996,1357,361,1.627907808,0.299358444,554,929,331,1,'01_25_02.c3d',21,EV,R,E,2,diff,375
897,1207,310,0.962757968,0.43106315,462,652,128,88,'01_25_03.c3d',21,EV,R,E,3,diff,190
910,1290,380,0.842671767,0.466535138,618,652,9,273,'01_25_04.c3d',21,EV,R,E,4,diff,34
834,1091,257,1.148084148,0.605257155,529,605,13,1,'01_25_05.c3d',21,EV,R,E,5,diff,76
961,1828,867,1.005767783,0.88900179,1186,800,84,464,'01_25_01.c3d',22,EV,R,E,1,diff,386
923,1472,549,0.911522034,0.699416698,600,852,301,1,'01_25_02.c3d',22,EV,R,E,2,diff,252
795,1122,327,1.070835637,0.823839206,582,714,286,1,'01_25_03.c3d',22,EV,R,E,3,diff,132
1244,1407,163,0.858292488,0.773892473,807,793,448,432,'01_25_04.c3d',22,EV,R,E,4,diff,14
922,1526,604,0.723189109,0.544977893,668,747,45,278,'01_25_05.c3d',22,EV,R,E,5,diff,79
2066,3143,1077,0.657860893,0.353756349,860,1282,1,1,'01_25_01.c3d',23,EV,R,E,1,diff,422
858,1218,360,1.048410953,0.753001578,744,687,1,351,'01_25_02.c3d',23,EV,R,E,2,diff,57
1878,2362,484,0.753092325,0.495051914,622,795,322,1,'01_25_03.c3d',23,EV,R,E,3,diff,173
1498,2741,1243,0.51394664,0.309755146,1752,1229,294,1,'01_25_04.c3d',23,EV,R,E,4,diff,523
1486,2940,1454,0.482368509,0.337475021,1837,1071,336,323,'01_25_05.c3d',23,EV,R,E,5,diff,766
769,1006,237,1.533494681,0.627720077,432,458,234,221,'01_25_01.c3d',24,EV,R,E,1,diff,26
705,1836,1131,1.367693716,0.620330088,567,592,231,225,'01_25_02.c3d',24,EV,R,E,2,diff,25
640,1741,1101,1.657990943,0.691769854,484,442,1,36,'01_25_03.c3d',24,EV,R,E,3,diff,42
679,964,285,1.244118659,0.601489791,466,558,217,185,'01_25_04.c3d',24,EV,R,E,4,diff,92
846,966,120,1.097020454,0.452360854,502,749,255,1,'01_25_05.c3d',24,EV,R,E,5,diff,247
802,1025,223,2.173592464,0.681275535,541,473,373,327,'01_25_01.c3d',25,EV,R,E,1,diff,68
625,1302,677,1.94008875,0.891166987,509,514,290,1,'01_25_02.c3d',25,EV,R,E,2,diff,5
681,4593,3912,1.310543754,0.878533546,539,641,271,278,'01_25_03.c3d',25,EV,R,E,3,diff,102
771,1353,582,1.14368368,0.633538224,618,682,275,289,'01_25_04.c3d',25,EV,R,E,4,diff,64
774,1064,290,1.565310786,0.499949243,528,605,246,245,'01_25_05.c3d',25,EV,R,E,5,diff,77
766,1472,706,1.153322536,0.511953329,567,673,324,1,'01_25_01.c3d',26,EV,R,E,1,diff,106
851,1442,591,1.733430765,0.516852559,557,568,270,248,'01_25_02.c3d',26,EV,R,E,2,diff,11
977,1295,318,0.985981599,0.454655438,661,449,308,1,'01_25_03.c3d',26,EV,R,E,3,diff,212
1081,3107,2026,0.761326167,0.350249199,582,534,294,1,'01_25_04.c3d',26,EV,R,E,4,diff,48
907,987,80,1.225467366,0.383100737,618,714,389,304,'01_25_05.c3d',26,EV,R,E,5,diff,96
885,1446,561,1.673459342,0.953005121,700,871,444,1,'01_25_01.c3d',27,EV,R,E,1,diff,171
1189,1751,562,1.165044678,0.551728907,760,1047,436,1,'01_25_02.c3d',27,EV,R,E,2,diff,287
1676,2418,742,0.775280154,0.714053387,1263,1487,1,1,'01_25_03.c3d',27,EV,R,E,3,diff,224
1668,1760,92,0.781628369,0.554984578,657,737,350,1,'01_25_04.c3d',27,EV,R,E,4,diff,80
1809,2226,417,1.136709521,0.704548273,1551,1686,115,1260,'01_25_05.c3d',27,EV,R,E,5,diff,135
928,1445,517,0.906026507,0.656054766,982,812,1,1,'01_25_01.c3d',28,EV,R,E,1,diff,170
1025,1575,550,0.772603646,0.488238129,986,873,403,295,'01_25_02.c3d',28,EV,R,E,2,diff,113
974,1977,1003,0.851292229,0.510406614,781,797,265,1,'01_25_03.c3d',28,EV,R,E,3,diff,16
1082,1344,262,0.737492927,0.405369676,876,786,255,1,'01_25_04.c3d',28,EV,R,E,4,diff,90
970,1409,439,1.060657731,0.530904166,447,807,1,281,'01_25_05.c3d',28,EV,R,E,5,diff,360
749,1467,718,1.950304229,0.896255376,552,565,332,1,'01_25_01.c3d',29,EV,R,E,1,diff,13
736,1101,365,2.094841481,0.847190759,552,494,314,298,'01_25_02.c3d',29,EV,R,E,2,diff,58
754,1051,297,1.400040258,0.710899638,493,564,78,1,'01_25_03.c3d',29,EV,R,E,3,diff,71
821,1093,272,1.194507889,0.630898054,531,681,266,1,'01_25_04.c3d',29,EV,R,E,4,diff,150
613,951,338,1.508874295,0.850336841,485,522,194,1,'01_25_05.c3d',29,EV,R,E,5,diff,37
829,882,53,0.939686252,0.438250136,455,705,158,1,'01_25_01.c3d',30,EV,R,E,1,diff,250
710,1561,851,1.131621873,0.535724513,501,595,1,1,'01_25_02.c3d',30,EV,R,E,2,diff,94
703,1039,336,0.875922957,0.447287135,443,367,76,1,'01_25_03.c3d',30,EV,R,E,3,diff,76
806,1377,571,0.863642528,0.470085397,494,418,184,1,'01_25_04.c3d',30,EV,R,E,4,diff,76
758,1154,396,0.960224159,0.471338438,497,583,54,1,'01_25_05.c3d',30,EV,R,E,5,diff,86
718,1279,561,2.455933771,1.051077791,618,640,385,375,'01_25_01.c3d',31,EV,R,E,1,diff,22
619,1686,1067,2.358420789,1.210502794,556,478,337,1,'01_25_02.c3d',31,EV,R,E,2,diff,78
623,1865,1242,2.589286386,1.131948449,569,555,328,298,'01_25_03.c3d',31,EV,R,E,3,diff,14
714,1476,762,1.883806125,1.011991639,520,622,301,281,'01_25_04.c3d',31,EV,R,E,4,diff,102
653,836,183,2.376299592,0.899722551,473,449,271,260,'01_25_05.c3d',31,EV,R,E,5,diff,24
1077,1087,10,1.501017734,0.700998471,766,943,25,550,'01_25_01.c3d',32,EV,R,E,1,diff,177
797,1193,396,1.388274462,0.659676365,539,726,1,1,'01_25_02.c3d',32,EV,R,E,2,diff,187
750,1506,756,1.766288354,0.699072985,507,659,1,1,'01_25_03.c3d',32,EV,R,E,3,diff,152
1349,1669,320,1.193144589,0.353271278,937,1276,391,438,'01_25_04.c3d',32,EV,R,E,4,diff,339
1000,1313,313,1.103722646,0.531317531,690,715,276,248,'01_25_05.c3d',32,EV,R,E,5,diff,25
1186,1585,399,0.965793904,0.599718565,877,1118,1,1,'01_25_01.c3d',33,EV,R,E,1,diff,241
979,1737,758,1.709476309,0.736938114,769,903,472,446,'01_25_02.c3d',33,EV,R,E,2,diff,134
878,1652,774,1.013694247,0.716649492,655,808,375,374,'01_25_03.c3d',33,EV,R,E,3,diff,153
901,1744,843,1.361610872,0.733760309,692,768,421,404,'01_25_04.c3d',33,EV,R,E,4,diff,76
1163,1357,194,1.264221053,0.643072394,536,660,59,273,'01_25_05.c3d',33,EV,R,E,5,diff,124
644,2450,1806,1.667464047,0.76157762,477,607,282,247,'01_25_01.c3d',34,EV,R,E,1,diff,130
659,1243,584,1.28066351,0.657688569,485,571,286,1,'01_25_02.c3d',34,EV,R,E,2,diff,86
815,1450,635,0.969066738,0.553712255,424,564,253,241,'01_25_03.c3d',34,EV,R,E,3,diff,140
655,1329,674,1.012772257,0.689254934,517,398,268,251,'01_25_04.c3d',34,EV,R,E,4,diff,119
677,1481,804,0.938749837,0.799994457,633,612,333,302,'01_25_05.c3d',34,EV,R,E,5,diff,21
748,946,198,1.615667823,0.642837297,465,583,237,229,'01_25_01.c3d',35,EV,R,E,1,diff,118
773,1041,268,1.940004957,0.683092847,555,460,321,307,'01_25_02.c3d',35,EV,R,E,2,diff,95
684,959,275,2.038962609,0.696135652,472,576,277,34,'01_25_03.c3d',35,EV,R,E,3,diff,104
653,1119,466,1.39108867,0.68139118,405,622,116,122,'01_25_04.c3d',35,EV,R,E,4,diff,217
716,948,232,1.742890694,0.652673974,471,571,164,191,'01_25_05.c3d',35,EV,R,E,5,diff,100
726,1226,500,0.753347318,0.856703209,504,1115,1,314,'01_23_01.c3d',1,EV,L,M,1,diff,611
739,1501,762,0.848290399,0.733979624,542,1319,1,1,'01_23_02.c3d',1,EV,L,M,2,diff,777
1167,1360,193,0.8736469,0.903641591,485,874,253,281,'01_23_03.c3d',1,EV,L,M,3,diff,389
611,1241,630,0.772624138,0.832821608,455,954,60,250,'01_23_04.c3d',1,EV,L,M,4,diff,499
556,1895,1339,0.987411757,1.027024017,479,753,25,251,'01_23_05.c3d',1,EV,L,M,5,diff,274
1388,1605,217,0.955668615,0.948256303,554,1169,1,44,'01_23_01.c3d',2,EV,L,M,1,diff,615
720,2273,1553,0.908129476,1.153662072,574,1086,1,317,'01_23_02.c3d',2,EV,L,M,2,diff,512
1184,1788,604,0.707967165,0.655091783,508,1328,249,299,'01_23_03.c3d',2,EV,L,M,3,diff,820
1203,1641,438,0.659172072,0.913850157,733,1342,1,1,'01_23_04.c3d',2,EV,L,M,4,diff,609
758,1197,439,0.834514362,1.113877024,595,955,1,1,'01_23_05.c3d',2,EV,L,M,5,diff,360
438,853,415,1.662147122,1.421353529,385,693,229,231,'01_23_01.c3d',3,EV,L,M,1,diff,308
445,829,384,1.454277904,1.33181356,397,701,94,162,'01_23_02.c3d',3,EV,L,M,2,diff,304
520,952,432,1.364548072,1.307444684,430,690,62,1,'01_23_03.c3d',3,EV,L,M,3,diff,260
400,828,428,1.051221046,1.402782561,329,675,41,169,'01_23_04.c3d',3,EV,L,M,4,diff,346
626,1027,401,1.08278708,1.430227605,513,735,1,1,'01_23_05.c3d',3,EV,L,M,5,diff,222
585,1464,879,1.265484616,1.201606708,507,758,35,319,'01_23_01.c3d',4,EV,L,M,1,diff,251
711,1991,1280,1.333566127,1.281349081,669,784,456,432,'01_23_02.c3d',4,EV,L,M,2,diff,115
696,1754,1058,1.231695092,1.446979454,519,747,20,328,'01_23_03.c3d',4,EV,L,M,3,diff,228
820,1655,835,1.022342775,0.857522087,511,779,128,1,'01_23_04.c3d',4,EV,L,M,4,diff,268
541,980,439,0.913354721,0.832338708,437,756,1,153,'01_23_05.c3d',4,EV,L,M,5,diff,319
485,867,382,1.678968158,1.216915742,400,704,1,265,'01_23_01.c3d',5,EV,L,M,1,diff,304
370,808,438,2.100532106,1.72764405,343,455,104,191,'01_23_02.c3d',5,EV,L,M,2,diff,112
509,1067,558,1.543529824,1.623469609,422,504,1,286,'01_23_03.c3d',5,EV,L,M,3,diff,82
456,729,273,1.364238408,1.496390594,368,639,214,218,'01_23_04.c3d',5,EV,L,M,4,diff,271
452,706,254,1.52087511,1.749663645,395,501,251,240,'01_23_05.c3d',5,EV,L,M,5,diff,106
952,1081,129,0.838818648,0.941703588,443,826,1,281,'01_23_01.c3d',6,EV,L,M,1,diff,383
553,1156,603,1.135035498,0.821461703,493,736,1,299,'01_23_02.c3d',6,EV,L,M,2,diff,243
537,1044,507,1.098516532,0.905017675,458,692,71,1,'01_23_03.c3d',6,EV,L,M,3,diff,234
936,1226,290,0.644944096,1.187770738,490,1115,1,335,'01_23_04.c3d',6,EV,L,M,4,diff,625
600,1386,786,0.97825927,0.914183481,471,1214,1,1,'01_23_05.c3d',6,EV,L,M,5,diff,743
1087,1755,668,0.840386198,0.69263335,540,768,8,348,'01_23_01.c3d',7,EV,L,M,1,diff,228
1114,1203,89,0.923184446,0.679188501,588,808,368,1,'01_23_02.c3d',7,EV,L,M,2,diff,220
524,953,429,1.001381292,0.983679138,415,686,1,1,'01_23_03.c3d',7,EV,L,M,3,diff,271
385,782,397,0.568322378,0.989735314,281,625,1,1,'01_23_04.c3d',7,EV,L,M,4,diff,344
894,930,36,0.776418146,0.778135697,433,612,19,206,'01_23_05.c3d',7,EV,L,M,5,diff,179
1158,2342,1184,0.881005978,0.941318864,582,800,1,1,'01_23_01.c3d',8,EV,L,M,1,diff,218
1084,1462,378,0.627256142,0.573297307,448,774,242,1,'01_23_02.c3d',8,EV,L,M,2,diff,326
1540,1954,414,0.514774371,0.573547317,487,982,265,289,'01_23_03.c3d',8,EV,L,M,3,diff,495
1443,1670,227,0.493510361,0.616168649,567,1203,1,365,'01_23_04.c3d',8,EV,L,M,4,diff,636
1080,1372,292,0.674430097,0.7129213,492,1055,2,1,'01_23_05.c3d',8,EV,L,M,5,diff,563
1324,2298,974,0.75838405,0.978599455,696,847,60,1,'01_23_01.c3d',9,EV,L,M,1,diff,151
874,1047,173,1.208359633,0.868230727,513,737,172,325,'01_23_02.c3d',9,EV,L,M,2,diff,224
887,1479,592,0.8930537,1.20163062,444,597,267,283,'01_23_03.c3d',9,EV,L,M,3,diff,153
663,908,245,1.246504122,1.015350043,414,522,238,233,'01_23_04.c3d',9,EV,L,M,4,diff,108
875,1368,493,0.721385455,0.775615128,482,591,233,229,'01_23_05.c3d',9,EV,L,M,5,diff,109
699,2667,1968,0.828473581,2.250000478,408,619,1,1,'01_23_01.c3d',10,EV,L,M,1,diff,211
847,879,32,1.250452295,2.085392969,492,730,1,67,'01_23_02.c3d',10,EV,L,M,2,diff,238
904,1337,433,0.935699082,1.503981019,409,656,31,251,'01_23_03.c3d',10,EV,L,M,3,diff,247
443,948,505,1.346496253,1.421310945,362,630,141,116,'01_23_04.c3d',10,EV,L,M,4,diff,268
961,1706,745,0.845992307,1.111057703,307,660,56,46,'01_23_05.c3d',10,EV,L,M,5,diff,353
1084,1266,182,0.634504173,0.915327236,630,1060,344,1,'01_23_01.c3d',11,EV,L,M,1,diff,430
1143,2100,957,0.480558748,0.405386751,638,1094,49,310,'01_23_02.c3d',11,EV,L,M,2,diff,456
1129,1709,580,0.508014726,0.563514647,646,1181,1,1,'01_23_03.c3d',11,EV,L,M,3,diff,535
1082,2693,1611,0.493262433,0.532455725,573,993,1,1,'01_23_04.c3d',11,EV,L,M,4,diff,420
1510,2351,841,0.393337276,0.479933302,648,1083,15,1,'01_23_05.c3d',11,EV,L,M,5,diff,435
468,1326,858,1.513619573,1.349881169,397,674,251,253,'01_23_01.c3d',12,EV,L,M,1,diff,277
575,919,344,1.137762315,1.011650711,443,759,276,1,'01_23_02.c3d',12,EV,L,M,2,diff,316
901,1146,245,1.051943592,1.116581658,418,733,253,275,'01_23_03.c3d',12,EV,L,M,3,diff,315
541,1128,587,0.799473573,0.730634703,448,595,180,243,'01_23_04.c3d',12,EV,L,M,4,diff,147
452,931,479,1.352030301,0.971061698,417,681,210,177,'01_23_05.c3d',12,EV,L,M,5,diff,264
561,1101,540,1.180256911,1.054345195,478,682,19,1,'01_23_01.c3d',13,EV,L,M,1,diff,204
474,1026,552,1.161137005,0.862981623,385,644,163,1,'01_23_02.c3d',13,EV,L,M,2,diff,259
696,1170,474,0.973878825,0.88583255,548,840,353,1,'01_23_03.c3d',13,EV,L,M,3,diff,292
563,885,322,1.114296954,1.26719684,479,717,1,221,'01_23_04.c3d',13,EV,L,M,4,diff,238
531,964,433,1.095498123,1.010596528,456,794,94,253,'01_23_05.c3d',13,EV,L,M,5,diff,338
442,1307,865,1.73070736,1.204024406,372,550,212,211,'01_23_01.c3d',14,EV,L,M,1,diff,178
647,804,157,1.255610099,2.223025423,383,502,1,215,'01_23_02.c3d',14,EV,L,M,2,diff,119
458,716,258,1.476130124,1.812990967,374,545,215,255,'01_23_03.c3d',14,EV,L,M,3,diff,171
801,858,57,1.373844795,1.713948217,433,666,1,315,'01_23_04.c3d',14,EV,L,M,4,diff,233
460,801,341,1.342568778,1.503815265,380,563,1,263,'01_23_05.c3d',14,EV,L,M,5,diff,183
880,1007,127,0.924372225,1.124538446,458,901,284,311,'01_23_01.c3d',15,EV,L,M,1,diff,443
613,1441,828,1.010762234,1.102732586,450,669,18,1,'01_23_02.c3d',15,EV,L,M,2,diff,219
482,833,351,0.995455066,1.193461253,369,702,122,91,'01_23_03.c3d',15,EV,L,M,3,diff,333
550,1054,504,1.173419711,1.132072783,437,694,13,267,'01_23_04.c3d',15,EV,L,M,4,diff,257
946,1034,88,0.856058434,1.126932478,376,648,96,152,'01_23_05.c3d',15,EV,L,M,5,diff,272
1309,2599,1290,0.670726771,0.796914216,547,1040,11,405,'01_23_01.c3d',16,EV,L,M,1,diff,493
551,1983,1432,1.493229904,1.194937377,490,631,302,289,'01_23_02.c3d',16,EV,L,M,2,diff,141
589,1062,473,1.07921502,1.083777978,487,844,285,1,'01_23_03.c3d',16,EV,L,M,3,diff,357
649,1187,538,1.256742118,1.188877128,526,743,314,341,'01_23_04.c3d',16,EV,L,M,4,diff,217
561,979,418,0.66741342,1.065461784,347,622,1,1,'01_23_05.c3d',16,EV,L,M,5,diff,275
476,831,355,1.66624458,1.625772316,382,542,259,1,'01_23_01.c3d',17,EV,L,M,1,diff,160
475,792,317,3.033437085,1.909507793,332,463,219,226,'01_23_02.c3d',17,EV,L,M,2,diff,131
459,668,209,2.873863166,2.08344916,327,331,231,232,'01_23_03.c3d',17,EV,L,M,3,diff,4
454,1965,1511,1.499243421,1.928452843,376,540,23,260,'01_23_04.c3d',17,EV,L,M,4,diff,164
971,992,21,1.416602974,1.537684448,367,528,237,245,'01_23_05.c3d',17,EV,L,M,5,diff,161
8,1679,1671,1.80327593,1.350335431,1,1,1,1,'01_23_01.c3d',18,EV,L,M,1,diff,0
474,923,449,1.45346379,1.625184509,432,616,1,249,'01_23_02.c3d',18,EV,L,M,2,diff,184
498,925,427,1.031509155,1.542925495,431,686,1,1,'01_23_03.c3d',18,EV,L,M,3,diff,255
445,869,424,1.165898508,1.37146059,383,611,178,1,'01_23_04.c3d',18,EV,L,M,4,diff,228
744,1826,1082,0.825281006,1.162111932,429,717,1,1,'01_23_05.c3d',18,EV,L,M,5,diff,288
556,982,426,1.220953008,1.007731091,450,679,271,284,'01_23_01.c3d',19,EV,L,M,1,diff,229
584,895,311,1.035112619,1.211650153,414,758,1,265,'01_23_02.c3d',19,EV,L,M,2,diff,344
619,1017,398,1.019029743,1.227074737,526,777,282,226,'01_23_03.c3d',19,EV,L,M,3,diff,251
739,978,239,0.817907035,1.117692162,550,774,271,251,'01_23_04.c3d',19,EV,L,M,4,diff,224
831,995,164,1.044438419,1.078969734,408,580,52,242,'01_23_05.c3d',19,EV,L,M,5,diff,172
512,1570,1058,1.452563326,1.155030138,443,725,274,1,'01_23_01.c3d',20,EV,L,M,1,diff,282
613,1397,784,1.184869982,1.113466053,484,684,290,288,'01_23_02.c3d',20,EV,L,M,2,diff,200
680,1120,440,1.276861121,1.214165063,571,711,1,414,'01_23_03.c3d',20,EV,L,M,3,diff,140
672,1615,943,1.415457303,0.947429094,581,873,222,415,'01_23_04.c3d',20,EV,L,M,4,diff,292
951,972,21,0.889097809,1.105769486,467,763,51,290,'01_23_05.c3d',20,EV,L,M,5,diff,296
745,1121,376,1.244444281,0.984543743,610,1121,419,414,'01_23_01.c3d',21,EV,L,M,1,diff,511
690,1722,1032,0.738569279,0.775338632,520,1043,145,1,'01_23_02.c3d',21,EV,L,M,2,diff,523
996,1220,224,1.041409681,0.992883833,600,1158,1,1,'01_23_03.c3d',21,EV,L,M,3,diff,558
956,1360,404,1.153215292,1.230086607,865,1206,59,701,'01_23_04.c3d',21,EV,L,M,4,diff,341
608,2047,1439,0.909271838,0.8714878,419,780,220,1,'01_23_05.c3d',21,EV,L,M,5,diff,361
652,1517,865,1.190730443,1.263277742,474,1203,292,573,'01_23_01.c3d',22,EV,L,M,1,diff,729
745,1736,991,0.79974503,1.209493184,486,821,278,308,'01_23_02.c3d',22,EV,L,M,2,diff,335
894,1685,791,0.788499301,1.504165406,547,1591,291,751,'01_23_03.c3d',22,EV,L,M,3,diff,1044
719,2181,1462,0.742016037,1.40151926,520,1502,289,838,'01_23_04.c3d',22,EV,L,M,4,diff,982
675,1588,913,0.869437674,1.312014535,501,1426,268,740,'01_23_05.c3d',22,EV,L,M,5,diff,925
1216,2284,1068,0.652899242,0.711083432,675,1404,425,445,'01_23_01.c3d',23,EV,L,M,1,diff,729
941,1733,792,0.521369167,0.751649741,487,1361,12,1,'01_23_02.c3d',23,EV,L,M,2,diff,874
3271,3491,220,0.236778138,0.44279282,642,1702,1,417,'01_23_03.c3d',23,EV,L,M,3,diff,1060
1645,2838,1193,0.353714858,0.793114357,975,1995,2,374,'01_23_04.c3d',23,EV,L,M,4,diff,1020
2465,4694,2229,0.328596824,0.559335018,758,1917,1,1,'01_23_05.c3d',23,EV,L,M,5,diff,1159
2642,3142,500,0.408943314,1.004452431,894,1338,259,1,'01_23_01.c3d',24,EV,L,M,1,diff,444
1306,1707,401,0.646045352,0.896690826,845,1350,28,644,'01_23_02.c3d',24,EV,L,M,2,diff,505
878,1078,200,0.964457434,0.946036479,435,784,266,1,'01_23_03.c3d',24,EV,L,M,3,diff,349
569,1511,942,0.856930093,1.028984775,385,730,54,147,'01_23_04.c3d',24,EV,L,M,4,diff,345
692,1016,324,0.881838031,1.008558496,394,779,1,1,'01_23_05.c3d',24,EV,L,M,5,diff,385
640,1183,543,0.918443266,0.989608215,556,703,261,278,'01_23_01.c3d',25,EV,L,M,1,diff,147
611,968,357,0.865240884,1.108416951,452,694,244,279,'01_23_02.c3d',25,EV,L,M,2,diff,242
889,1141,252,0.746349547,0.811880097,487,768,293,304,'01_23_03.c3d',25,EV,L,M,3,diff,281
685,1029,344,0.909538217,0.928906888,417,690,233,256,'01_23_04.c3d',25,EV,L,M,4,diff,273
841,899,58,1.055585267,1.070041028,464,685,38,251,'01_23_05.c3d',25,EV,L,M,5,diff,221
1144,1228,84,0.584080841,0.748607598,503,810,1,199,'01_23_01.c3d',26,EV,L,M,1,diff,307
995,1168,173,0.669838236,0.859054861,549,805,320,303,'01_23_02.c3d',26,EV,L,M,2,diff,256
1550,4618,3068,0.494649915,0.534100601,526,1172,339,1,'01_23_03.c3d',26,EV,L,M,3,diff,646
1462,1831,369,0.522335475,0.455719292,494,1074,28,1,'01_23_04.c3d',26,EV,L,M,4,diff,580
643,1242,599,0.959520937,0.676837813,566,1019,1,302,'01_23_05.c3d',26,EV,L,M,5,diff,453
892,1330,438,0.945347763,1.022206058,724,1120,42,1,'01_23_01.c3d',27,EV,L,M,1,diff,396
1123,1315,192,0.822025025,0.959001277,616,841,400,1,'01_23_02.c3d',27,EV,L,M,2,diff,225
892,1186,294,1.302518442,1.155369152,665,960,456,1,'01_23_03.c3d',27,EV,L,M,3,diff,295
1470,1727,257,0.336702488,0.943500494,895,1170,1,423,'01_23_04.c3d',27,EV,L,M,4,diff,275
1142,1421,279,0.771400335,0.92558333,591,945,61,417,'01_23_05.c3d',27,EV,L,M,5,diff,354
804,1690,886,0.765641218,0.826762627,590,1385,360,1,'01_23_01.c3d',28,EV,L,M,1,diff,795
1015,2002,987,0.994913864,0.66282959,475,1602,244,1,'01_23_02.c3d',28,EV,L,M,2,diff,1127
810,1454,644,0.737571521,0.85649617,731,1058,281,1,'01_23_03.c3d',28,EV,L,M,3,diff,327
1032,1608,576,0.599203821,0.80436761,930,1286,1,1,'01_23_04.c3d',28,EV,L,M,4,diff,356
994,1232,238,1.042456875,0.918765806,472,944,1,1,'01_23_05.c3d',28,EV,L,M,5,diff,472
543,1491,948,1.143286363,1.349543371,480,662,277,300,'01_23_01.c3d',29,EV,L,M,1,diff,182
578,777,199,1.212369826,1.910539483,471,658,311,326,'01_23_02.c3d',29,EV,L,M,2,diff,187
538,888,350,1.091034385,1.356571386,451,674,1,281,'01_23_03.c3d',29,EV,L,M,3,diff,223
861,923,62,0.868502653,1.161944275,429,772,1,216,'01_23_04.c3d',29,EV,L,M,4,diff,343
584,1089,505,1.106372843,1.333934999,479,771,1,1,'01_23_05.c3d',29,EV,L,M,5,diff,292
554,1462,908,1.091582107,0.972343584,455,640,206,288,'01_23_01.c3d',30,EV,L,M,1,diff,185
825,1109,284,0.794460244,0.732654601,423,800,17,104,'01_23_02.c3d',30,EV,L,M,2,diff,377
624,1028,404,0.913528276,0.962948912,485,670,1,310,'01_23_03.c3d',30,EV,L,M,3,diff,185
845,967,122,0.700757608,0.826859823,423,771,12,1,'01_23_04.c3d',30,EV,L,M,4,diff,348
840,1110,270,0.472215775,0.748468019,375,731,1,225,'01_23_05.c3d',30,EV,L,M,5,diff,356
912,962,50,1.543309232,1.507276619,455,562,275,276,'01_23_01.c3d',31,EV,L,M,1,diff,107
587,1144,557,1.606679768,1.407629614,503,674,316,1,'01_23_02.c3d',31,EV,L,M,2,diff,171
690,992,302,1.70486533,1.588361853,488,659,324,330,'01_23_03.c3d',31,EV,L,M,3,diff,171
581,1156,575,1.641196147,1.140290892,455,721,292,292,'01_23_04.c3d',31,EV,L,M,4,diff,266
1054,1251,197,1.390684807,1.206971723,483,719,2,320,'01_23_05.c3d',31,EV,L,M,5,diff,236
680,1167,487,1.193302717,1.024647425,561,888,372,1,'01_23_01.c3d',32,EV,L,M,1,diff,327
1041,1322,281,0.76700633,0.864394935,502,947,285,313,'01_23_02.c3d',32,EV,L,M,2,diff,445
1017,1238,221,0.594414486,0.918134032,519,1025,296,320,'01_23_03.c3d',32,EV,L,M,3,diff,506
1063,1147,84,0.695457566,1.027753836,533,811,1,291,'01_23_04.c3d',32,EV,L,M,4,diff,278
730,1105,375,0.725245842,1.124099171,543,817,73,313,'01_23_05.c3d',32,EV,L,M,5,diff,274
976,1315,339,0.88322978,0.804717823,553,831,278,1,'01_23_01.c3d',33,EV,L,M,1,diff,278
892,1250,358,0.648445357,0.919590633,555,1071,69,316,'01_23_02.c3d',33,EV,L,M,2,diff,516
815,1169,354,0.820339149,0.917497721,496,882,298,1,'01_23_03.c3d',33,EV,L,M,3,diff,386
1243,1842,599,0.774587913,1.022246206,577,987,400,1,'01_23_04.c3d',33,EV,L,M,4,diff,410
1405,1594,189,0.545244864,1.008418111,1055,1300,1,1,'01_23_05.c3d',33,EV,L,M,5,diff,245
1015,1748,733,0.727612022,0.934377985,527,768,59,313,'01_23_01.c3d',34,EV,L,M,1,diff,241
603,1014,411,1.080157043,1.051361188,510,755,1,327,'01_23_02.c3d',34,EV,L,M,2,diff,245
544,1099,555,0.946163897,0.996188137,432,729,55,1,'01_23_03.c3d',34,EV,L,M,3,diff,297
636,987,351,0.838974606,1.00283766,508,800,1,310,'01_23_04.c3d',34,EV,L,M,4,diff,292
565,967,402,1.039876735,1.177646258,509,594,21,259,'01_23_05.c3d',34,EV,L,M,5,diff,85
528,991,463,1.46878284,1.093176191,423,645,247,245,'01_23_01.c3d',35,EV,L,M,1,diff,222
363,828,465,0.899923699,1.009378107,235,544,1,1,'01_23_02.c3d',35,EV,L,M,2,diff,309
346,928,582,1.397394298,0.926814215,259,615,56,52,'01_23_03.c3d',35,EV,L,M,3,diff,356
376,963,587,1.083361201,0.89327191,295,648,7,49,'01_23_04.c3d',35,EV,L,M,4,diff,353
435,1248,813,1.563914725,0.919573579,380,580,90,170,'01_23_05.c3d',35,EV,L,M,5,diff,200
2078,2749,671,0.758698076,1.000604094,538,964,27,381,'01_24_01.c3d',1,EV,L,H,1,diff,426
1165,1171,6,0.829040154,0.947583602,505,927,1,317,'01_24_02.c3d',1,EV,L,H,2,diff,422
996,1884,888,0.451066607,0.779973465,448,1033,12,285,'01_24_03.c3d',1,EV,L,H,3,diff,585
1041,2685,1644,0.647448684,0.991330101,386,751,209,209,'01_24_04.c3d',1,EV,L,H,4,diff,365
1433,2128,695,0.482027142,0.754970898,769,1182,128,201,'01_24_05.c3d',1,EV,L,H,5,diff,413
1069,1550,481,0.843486588,0.842415238,494,1309,18,1,'01_24_01.c3d',2,EV,L,H,1,diff,815
1012,1838,826,0.68384423,0.777295284,525,1445,285,1,'01_24_02.c3d',2,EV,L,H,2,diff,920
730,1395,665,0.673204611,0.911071191,533,1242,13,293,'01_24_03.c3d',2,EV,L,H,3,diff,709
745,1518,773,1.023508284,0.868246119,650,1328,1,380,'01_24_04.c3d',2,EV,L,H,4,diff,678
1064,1669,605,0.65407791,0.689060325,507,1256,252,1,'01_24_05.c3d',2,EV,L,H,5,diff,749
867,1276,409,0.825312631,1.218695696,724,1087,311,1,'01_24_01.c3d',3,EV,L,H,1,diff,363
991,2462,1471,1.234369512,1.14133464,408,657,2,1,'01_24_02.c3d',3,EV,L,H,2,diff,249
462,978,516,1.462331747,1.056617258,404,687,83,1,'01_24_03.c3d',3,EV,L,H,3,diff,283
564,886,322,0.984089054,1.189444665,419,742,1,1,'01_24_04.c3d',3,EV,L,H,4,diff,323
567,973,406,0.76745666,1.26290675,579,775,222,227,'01_24_05.c3d',3,EV,L,H,5,diff,196
671,940,269,1.277394185,1.246479209,469,635,213,254,'01_24_01.c3d',4,EV,L,H,1,diff,166
1037,1220,183,0.975645648,0.824005262,558,1054,120,1,'01_24_02.c3d',4,EV,L,H,2,diff,496
612,1009,397,0.857807826,0.849057495,441,859,1,40,'01_24_03.c3d',4,EV,L,H,3,diff,418
1014,1284,270,0.833046926,0.822774829,550,1077,1,1,'01_24_04.c3d',4,EV,L,H,4,diff,527
811,1161,350,0.743971528,0.920347567,629,951,382,400,'01_24_05.c3d',4,EV,L,H,5,diff,322
839,967,128,0.937326099,1.648167162,403,620,1,286,'01_24_01.c3d',5,EV,L,H,1,diff,217
480,1091,611,1.581646542,1.213400106,376,612,1,1,'01_24_02.c3d',5,EV,L,H,2,diff,236
464,760,296,1.688476397,1.506592728,395,539,259,257,'01_24_03.c3d',5,EV,L,H,3,diff,144
463,916,453,1.900091773,1.264615393,452,559,1,282,'01_24_04.c3d',5,EV,L,H,4,diff,107
517,1166,649,1.820325655,1.353342873,462,583,89,1,'01_24_05.c3d',5,EV,L,H,5,diff,121
917,1369,452,0.948816304,0.997777249,540,1224,368,1,'01_24_01.c3d',6,EV,L,H,1,diff,684
581,1238,657,1.080190181,0.833343848,459,1011,1,292,'01_24_02.c3d',6,EV,L,H,2,diff,552
933,1494,561,0.906449399,1.008621832,480,1286,1,286,'01_24_03.c3d',6,EV,L,H,3,diff,806
559,1270,711,1.2715669,0.788579356,501,951,301,1,'01_24_04.c3d',6,EV,L,H,4,diff,450
673,1281,608,0.662343738,0.745997809,573,1017,12,294,'01_24_05.c3d',6,EV,L,H,5,diff,444
1107,1268,161,0.667664784,0.569509859,484,865,290,1,'01_24_01.c3d',7,EV,L,H,1,diff,381
645,1227,582,0.887290673,0.654985774,479,841,75,113,'01_24_02.c3d',7,EV,L,H,2,diff,362
915,983,68,0.775077503,0.75698057,423,725,213,237,'01_24_03.c3d',7,EV,L,H,3,diff,302
806,951,145,0.965750945,0.784726901,417,749,243,1,'01_24_04.c3d',7,EV,L,H,4,diff,332
556,2268,1712,0.806975722,0.698363614,399,873,1,1,'01_24_05.c3d',7,EV,L,H,5,diff,474
1346,1607,261,0.728424569,0.588270293,441,987,52,225,'01_24_01.c3d',8,EV,L,H,1,diff,546
1626,2120,494,0.560164027,0.622558441,533,1285,16,354,'01_24_02.c3d',8,EV,L,H,2,diff,752
1502,1644,142,0.545765404,0.541550567,494,1292,276,278,'01_24_03.c3d',8,EV,L,H,3,diff,798
698,1897,1199,0.528713348,0.697199246,329,943,129,1,'01_24_04.c3d',8,EV,L,H,4,diff,614
1583,2551,968,0.53547921,0.433936591,664,1393,1,449,'01_24_05.c3d',8,EV,L,H,5,diff,729
1196,1955,759,0.336581778,0.842056237,564,625,1,273,'01_24_01.c3d',9,EV,L,H,1,diff,61
935,1619,684,0.836808321,0.750773817,509,848,326,1,'01_24_02.c3d',9,EV,L,H,2,diff,339
1590,1607,17,0.485128174,0.659686138,740,872,386,88,'01_24_03.c3d',9,EV,L,H,3,diff,132
891,2352,1461,0.612576389,0.414515065,419,1911,38,200,'01_24_04.c3d',9,EV,L,H,4,diff,1492
1017,1754,737,0.745624208,0.569376992,606,1637,40,354,'01_24_05.c3d',9,EV,L,H,5,diff,1031
744,807,63,1.449900995,2.025849841,438,499,292,307,'01_24_01.c3d',10,EV,L,H,1,diff,61
829,887,58,1.077726047,1.647408084,407,646,252,301,'01_24_02.c3d',10,EV,L,H,2,diff,239
1006,1416,410,0.631480109,1.155197472,379,645,16,191,'01_24_03.c3d',10,EV,L,H,3,diff,266
965,1468,503,0.489720143,1.280370881,347,597,1,222,'01_24_04.c3d',10,EV,L,H,4,diff,250
810,854,44,0.696453549,1.54225374,404,660,1,1,'01_24_05.c3d',10,EV,L,H,5,diff,256
1646,2373,727,0.442961283,0.482682935,1227,1409,1,1,'01_24_01.c3d',11,EV,L,H,1,diff,182
1288,2515,1227,0.370516752,0.52029514,776,1169,1,1,'01_24_02.c3d',11,EV,L,H,2,diff,393
1410,4720,3310,0.369174475,0.402644244,590,1099,1,317,'01_24_03.c3d',11,EV,L,H,3,diff,509
1335,2436,1101,0.291655619,0.511441703,1237,1263,309,360,'01_24_04.c3d',11,EV,L,H,4,diff,26
1153,1807,654,0.447612952,0.464120399,588,1095,276,1,'01_24_05.c3d',11,EV,L,H,5,diff,507
514,1564,1050,1.366588107,1.168203756,439,739,284,277,'01_24_01.c3d',12,EV,L,H,1,diff,300
786,968,182,1.005810189,0.959721604,393,701,235,226,'01_24_02.c3d',12,EV,L,H,2,diff,308
590,1210,620,1.21376848,0.7465265,494,818,320,354,'01_24_03.c3d',12,EV,L,H,3,diff,324
1045,1174,129,1.057978734,0.835602495,415,752,232,260,'01_24_04.c3d',12,EV,L,H,4,diff,337
735,1097,362,0.951902013,0.769982675,394,686,1,241,'01_24_05.c3d',12,EV,L,H,5,diff,292
628,1109,481,1.002917305,0.929481614,454,792,228,260,'01_24_01.c3d',13,EV,L,H,1,diff,338
604,1031,427,1.092176794,1.046820563,506,888,52,1,'01_24_02.c3d',13,EV,L,H,2,diff,382
849,1143,294,0.992055695,0.972077281,474,832,163,336,'01_24_03.c3d',13,EV,L,H,3,diff,358
814,1166,352,0.920741879,1.07090816,655,951,45,429,'01_24_04.c3d',13,EV,L,H,4,diff,296
554,1086,532,1.029148878,0.926658674,460,802,1,268,'01_24_05.c3d',13,EV,L,H,5,diff,342
539,889,350,1.393122358,1.388384902,417,680,258,1,'01_24_01.c3d',14,EV,L,H,1,diff,263
451,779,328,1.699101716,1.432164175,386,637,1,1,'01_24_02.c3d',14,EV,L,H,2,diff,251
727,1060,333,1.680372307,1.580219339,682,905,1,1,'01_24_03.c3d',14,EV,L,H,3,diff,223
451,747,296,1.645969092,2.091134809,370,542,17,255,'01_24_04.c3d',14,EV,L,H,4,diff,172
642,1041,399,1.34313027,1.07481882,365,733,216,205,'01_24_05.c3d',14,EV,L,H,5,diff,368
1164,1650,486,0.743599856,1.045754801,492,746,89,1,'01_24_01.c3d',15,EV,L,H,1,diff,254
448,860,412,1.248625265,1.516998817,390,609,122,197,'01_24_02.c3d',15,EV,L,H,2,diff,219
843,1030,187,1.07804934,1.129190347,419,693,1,293,'01_24_03.c3d',15,EV,L,H,3,diff,274
777,1037,260,0.877425842,0.967257207,345,718,24,1,'01_24_04.c3d',15,EV,L,H,4,diff,373
820,994,174,0.533082393,1.009749106,424,660,1,1,'01_24_05.c3d',15,EV,L,H,5,diff,236
558,1384,826,1.073712152,1.517936196,423,650,1,222,'01_24_01.c3d',16,EV,L,H,1,diff,227
1012,1078,66,1.007844726,1.027085956,431,636,1,263,'01_24_02.c3d',16,EV,L,H,2,diff,205
1096,1559,463,1.171054845,1.225399366,439,731,285,231,'01_24_03.c3d',16,EV,L,H,3,diff,292
503,1072,569,1.255196546,1.012693329,385,613,1,1,'01_24_04.c3d',16,EV,L,H,4,diff,228
1162,1809,647,0.840319609,0.99349232,414,672,1,1,'01_24_05.c3d',16,EV,L,H,5,diff,258
446,970,524,1.824305278,1.297175081,370,610,258,261,'01_24_01.c3d',17,EV,L,H,1,diff,240
414,906,492,1.886524303,1.254160729,373,500,248,248,'01_24_02.c3d',17,EV,L,H,2,diff,127
569,848,279,2.58224912,1.437372066,438,540,309,306,'01_24_03.c3d',17,EV,L,H,3,diff,102
492,776,284,2.504228048,1.421159833,359,413,236,233,'01_24_04.c3d',17,EV,L,H,4,diff,54
468,888,420,1.891262458,1.350565461,370,556,263,258,'01_24_05.c3d',17,EV,L,H,5,diff,186
671,1148,477,1.288587532,1.537484332,544,877,396,412,'01_24_01.c3d',18,EV,L,H,1,diff,333
575,1092,517,1.295628093,1.221549065,499,716,324,320,'01_24_02.c3d',18,EV,L,H,2,diff,217
588,1986,1398,1.550419493,1.374511391,375,647,1,1,'01_24_03.c3d',18,EV,L,H,3,diff,272
324,777,453,1.327230452,1.328688875,570,568,1,1,'01_24_04.c3d',18,EV,L,H,4,diff,2
596,1183,587,1.179847157,1.167109964,530,789,1,1,'01_24_05.c3d',18,EV,L,H,5,diff,259
1364,1461,97,0.575067739,0.842155613,549,923,1,1,'01_24_01.c3d',19,EV,L,H,1,diff,374
1046,1413,367,0.704870639,1.006012989,503,827,322,330,'01_24_02.c3d',19,EV,L,H,2,diff,324
1014,1597,583,0.820240895,1.071408774,450,751,235,250,'01_24_03.c3d',19,EV,L,H,3,diff,301
912,1336,424,0.8720147,0.895372647,440,590,1,258,'01_24_04.c3d',19,EV,L,H,4,diff,150
604,994,390,1.099800946,1.337358892,474,633,294,312,'01_24_05.c3d',19,EV,L,H,5,diff,159
949,1083,134,1.034432568,0.992849592,513,774,1,354,'01_24_01.c3d',20,EV,L,H,1,diff,261
683,1181,498,1.221123366,0.984429119,570,707,405,401,'01_24_02.c3d',20,EV,L,H,2,diff,137
498,1124,626,1.344043216,0.856781025,423,755,256,250,'01_24_03.c3d',20,EV,L,H,3,diff,332
659,1132,473,0.78810476,0.916249305,453,741,138,1,'01_24_04.c3d',20,EV,L,H,4,diff,288
934,1128,194,0.872332565,0.88680263,429,729,1,259,'01_24_05.c3d',20,EV,L,H,5,diff,300
574,1380,806,1.076291748,0.867644581,478,731,32,1,'01_24_01.c3d',21,EV,L,H,1,diff,253
868,2976,2108,0.719992642,0.666677645,468,1128,1,324,'01_24_02.c3d',21,EV,L,H,2,diff,660
857,2374,1517,0.680362584,0.650598506,431,828,1,275,'01_24_03.c3d',21,EV,L,H,3,diff,397
978,1341,363,0.919890379,0.719647263,490,1088,1,1,'01_24_04.c3d',21,EV,L,H,4,diff,598
853,1660,807,0.738321859,0.635308077,450,679,81,241,'01_24_05.c3d',21,EV,L,H,5,diff,229
753,1442,689,1.007997719,1.336917101,546,1208,318,1,'01_24_01.c3d',22,EV,L,H,1,diff,662
783,1352,569,0.722193385,0.937728657,583,904,10,351,'01_24_02.c3d',22,EV,L,H,2,diff,321
967,1575,608,0.698676079,0.806894693,505,916,255,1,'01_24_03.c3d',22,EV,L,H,3,diff,411
780,1462,682,0.799896586,0.888743223,512,1259,277,328,'01_24_04.c3d',22,EV,L,H,4,diff,747
853,1497,644,0.804477009,0.878878074,513,1229,60,315,'01_24_05.c3d',22,EV,L,H,5,diff,716
2246,2994,748,0.308373198,0.656029815,1422,2024,28,609,'01_24_01.c3d',23,EV,L,H,1,diff,602
1670,2822,1152,0.472174758,0.496435673,533,1795,13,427,'01_24_02.c3d',23,EV,L,H,2,diff,1262
2696,3183,487,0.392070202,0.787760098,1050,1916,1,528,'01_24_03.c3d',23,EV,L,H,3,diff,866
2158,3142,984,0.280288509,0.484165007,478,1608,15,256,'01_24_04.c3d',23,EV,L,H,4,diff,1130
2007,2278,271,0.363766249,0.685334887,751,1595,28,395,'01_24_05.c3d',23,EV,L,H,5,diff,844
733,1033,300,1.00429097,0.997717313,392,764,79,267,'01_24_01.c3d',24,EV,L,H,1,diff,372
497,1021,524,1.408822997,0.941846896,405,929,232,248,'01_24_02.c3d',24,EV,L,H,2,diff,524
1118,1267,149,0.82997424,0.870562661,402,893,237,267,'01_24_03.c3d',24,EV,L,H,3,diff,491
784,1151,367,1.028894416,0.797277774,398,699,207,1,'01_24_04.c3d',24,EV,L,H,4,diff,301
872,1219,347,0.761823806,0.737868534,375,1007,13,1,'01_24_05.c3d',24,EV,L,H,5,diff,632
513,1184,671,1.175652285,0.873692996,428,614,42,241,'01_24_01.c3d',25,EV,L,H,1,diff,186
936,1331,395,0.80799592,0.687127877,506,890,304,328,'01_24_02.c3d',25,EV,L,H,2,diff,384
849,1027,178,0.79990219,0.807173446,397,615,1,126,'01_24_03.c3d',25,EV,L,H,3,diff,218
808,1018,210,0.972980206,0.791163263,389,747,210,188,'01_24_04.c3d',25,EV,L,H,4,diff,358
430,1111,681,0.611065602,0.762753414,138,514,1,20,'01_24_05.c3d',25,EV,L,H,5,diff,376
1536,1708,172,0.727504484,0.626863061,677,1284,481,1,'01_24_01.c3d',26,EV,L,H,1,diff,607
1263,3187,1924,0.729031183,0.719157654,617,799,180,1,'01_24_02.c3d',26,EV,L,H,2,diff,182
1383,1459,76,0.370052838,0.593835399,1417,1073,34,281,'01_24_03.c3d',26,EV,L,H,3,diff,344
1451,2534,1083,0.612715633,0.78514733,724,1408,1,1,'01_24_04.c3d',26,EV,L,H,4,diff,684
1486,3277,1791,0.644424901,0.499248824,496,938,30,268,'01_24_05.c3d',26,EV,L,H,5,diff,442
1180,1574,394,0.656747611,0.759034814,709,1068,1,431,'01_24_01.c3d',27,EV,L,H,1,diff,359
941,1283,342,1.082413142,0.917399149,560,830,61,345,'01_24_02.c3d',27,EV,L,H,2,diff,270
1073,1346,273,0.845063362,0.984689888,685,1168,1,439,'01_24_03.c3d',27,EV,L,H,3,diff,483
1247,1408,161,0.535925085,1.012484379,642,1019,29,412,'01_24_04.c3d',27,EV,L,H,4,diff,377
1270,1495,225,0.738143211,0.820997683,601,905,384,398,'01_24_05.c3d',27,EV,L,H,5,diff,304
1161,2195,1034,0.677711525,0.857032482,582,1386,36,1,'01_24_01.c3d',28,EV,L,H,1,diff,804
968,1560,592,0.71831083,0.842552195,476,1046,242,1,'01_24_02.c3d',28,EV,L,H,2,diff,570
899,1191,292,0.906654387,0.958390879,447,954,240,284,'01_24_03.c3d',28,EV,L,H,3,diff,507
913,1458,545,0.82265162,0.962943427,452,993,97,259,'01_24_04.c3d',28,EV,L,H,4,diff,541
1063,2482,1419,0.503737094,0.81306114,555,1283,1,355,'01_24_05.c3d',28,EV,L,H,5,diff,728
1039,1083,44,0.815632871,1.013174075,460,736,2,311,'01_24_01.c3d',29,EV,L,H,1,diff,276
1145,2663,1518,0.649007871,0.810248882,787,1079,1,1,'01_24_02.c3d',29,EV,L,H,2,diff,292
1199,1998,799,0.865446275,0.632153037,499,1171,1,121,'01_24_03.c3d',29,EV,L,H,3,diff,672
681,1082,401,0.807267296,0.871129013,413,782,224,212,'01_24_04.c3d',29,EV,L,H,4,diff,369
485,1074,589,0.605780926,0.863087389,386,684,1,1,'01_24_05.c3d',29,EV,L,H,5,diff,298
927,1472,545,0.842404607,0.712102255,622,988,16,1,'01_24_01.c3d',30,EV,L,H,1,diff,366
861,1026,165,0.91599691,0.85666421,436,773,234,1,'01_24_02.c3d',30,EV,L,H,2,diff,337
887,1081,194,0.776752516,0.765255648,428,853,1,1,'01_24_03.c3d',30,EV,L,H,3,diff,425
889,1242,353,0.481746526,0.736822033,429,873,31,1,'01_24_04.c3d',30,EV,L,H,4,diff,444
1119,1608,489,0.339166781,0.639163025,356,785,1,65,'01_24_05.c3d',30,EV,L,H,5,diff,429
750,1089,339,1.621019345,1.667621715,602,708,426,1,'01_24_01.c3d',31,EV,L,H,1,diff,106
518,1326,808,2.118703683,1.515636087,449,563,60,308,'01_24_02.c3d',31,EV,L,H,2,diff,114
605,3686,3081,1.889572107,1.186951912,445,684,283,295,'01_24_03.c3d',31,EV,L,H,3,diff,239
1008,1175,167,1.444046548,1.033664249,542,762,348,350,'01_24_04.c3d',31,EV,L,H,4,diff,220
928,1063,135,1.273101579,1.166451138,459,651,282,269,'01_24_05.c3d',31,EV,L,H,5,diff,192
1667,1840,173,0.566004929,0.742621735,605,1314,442,459,'01_24_01.c3d',32,EV,L,H,1,diff,709
662,1073,411,0.947870832,0.960075589,549,755,1,312,'01_24_02.c3d',32,EV,L,H,2,diff,206
1135,1311,176,0.534704772,0.737982323,554,858,296,327,'01_24_03.c3d',32,EV,L,H,3,diff,304
947,1342,395,0.771778994,0.871902666,521,815,281,1,'01_24_04.c3d',32,EV,L,H,4,diff,294
1256,1278,22,0.541347997,1.047741672,781,828,265,1,'01_24_05.c3d',32,EV,L,H,5,diff,47
1185,2260,1075,0.474101398,0.913858931,656,2083,32,1232,'01_24_01.c3d',33,EV,L,H,1,diff,1427
1151,1368,217,0.600153059,0.828985615,678,1280,1,326,'01_24_02.c3d',33,EV,L,H,2,diff,602
1158,1300,142,0.652419193,0.917465346,710,1071,344,1,'01_24_03.c3d',33,EV,L,H,3,diff,361
717,2451,1734,0.810990846,0.991231754,505,959,44,291,'01_24_04.c3d',33,EV,L,H,4,diff,454
977,2571,1594,0.885268966,0.663822007,565,964,1,340,'01_24_05.c3d',33,EV,L,H,5,diff,399
557,1022,465,1.43899979,0.880532969,471,817,334,1,'01_24_01.c3d',34,EV,L,H,1,diff,346
465,1695,1230,1.589675448,1.136678577,389,599,260,249,'01_24_02.c3d',34,EV,L,H,2,diff,210
497,969,472,1.244850744,0.960734662,400,755,239,257,'01_24_03.c3d',34,EV,L,H,3,diff,355
580,1026,446,1.178131462,0.897368904,447,737,224,266,'01_24_04.c3d',34,EV,L,H,4,diff,290
535,1140,605,0.842617582,0.900555617,442,634,1,1,'01_24_05.c3d',34,EV,L,H,5,diff,192
891,1147,256,1.084025589,0.924451406,421,699,1,249,'01_24_01.c3d',35,EV,L,H,1,diff,278
602,1082,480,1.166865844,1.022591995,466,743,267,1,'01_24_02.c3d',35,EV,L,H,2,diff,277
706,1329,623,1.124317302,0.825555162,606,831,118,1,'01_24_03.c3d',35,EV,L,H,3,diff,225
851,988,137,0.859100732,0.916788525,408,677,1,1,'01_24_04.c3d',35,EV,L,H,4,diff,269
768,1514,746,0.715322351,0.948551773,164,553,1,1,'01_24_05.c3d',35,EV,L,H,5,diff,389
953,2562,1609,1.033542972,0.452983642,564,715,321,311,'01_26_01.c3d',1,EV,R,M,1,diff,151
970,1082,112,1.219522052,0.408416636,564,639,181,1,'01_26_02.c3d',1,EV,R,M,2,diff,75
803,950,147,1.175213637,0.461472409,512,466,1,1,'01_26_03.c3d',1,EV,R,M,3,diff,46
848,1504,656,1.287297423,0.632766825,612,679,44,1,'01_26_04.c3d',1,EV,R,M,4,diff,67
809,1191,382,1.070017232,0.495195298,691,631,38,134,'01_26_05.c3d',1,EV,R,M,5,diff,60
1059,1940,881,0.97265188,0.597167976,551,905,353,1,'01_26_01.c3d',2,EV,R,M,1,diff,354
943,1341,398,0.991069175,0.489944713,528,749,274,1,'01_26_02.c3d',2,EV,R,M,2,diff,221
1109,1745,636,0.90383572,0.423528772,505,630,1,1,'01_26_03.c3d',2,EV,R,M,3,diff,125
1088,1373,285,0.834600324,0.498886079,512,749,204,224,'01_26_04.c3d',2,EV,R,M,4,diff,237
921,1060,139,0.852364111,0.476729774,492,640,86,63,'01_26_05.c3d',2,EV,R,M,5,diff,148
775,915,140,1.731016975,0.667653977,540,604,27,1,'01_26_01.c3d',3,EV,R,M,1,diff,64
879,898,19,1.841910528,0.948125501,503,512,4,300,'01_26_02.c3d',3,EV,R,M,2,diff,9
808,1447,639,1.712227361,0.615937368,801,429,95,1,'01_26_03.c3d',3,EV,R,M,3,diff,372
763,1834,1071,1.301914506,0.535067231,461,588,75,1,'01_26_04.c3d',3,EV,R,M,4,diff,127
803,925,122,1.407773009,0.579521526,493,544,18,1,'01_26_05.c3d',3,EV,R,M,5,diff,51
691,1940,1249,2.078427699,0.690615187,524,546,326,313,'01_26_01.c3d',4,EV,R,M,1,diff,22
748,1397,649,1.739345276,0.681861915,538,684,300,265,'01_26_02.c3d',4,EV,R,M,2,diff,146
749,852,103,1.797914692,0.550346334,497,710,303,1,'01_26_03.c3d',4,EV,R,M,3,diff,213
924,1290,366,0.937106497,0.469791507,542,680,271,272,'01_26_04.c3d',4,EV,R,M,4,diff,138
997,1293,296,1.174715625,0.460747365,497,703,1,1,'01_26_05.c3d',4,EV,R,M,5,diff,206
656,739,83,2.097357501,0.70571487,425,632,1,1,'01_26_01.c3d',5,EV,R,M,1,diff,207
991,1247,256,2.391273933,1.142991008,411,525,269,259,'01_26_02.c3d',5,EV,R,M,2,diff,114
640,1139,499,2.198782036,0.908629777,445,539,286,264,'01_26_03.c3d',5,EV,R,M,3,diff,94
579,648,69,4.24808427,1.422269305,473,454,355,1,'01_26_04.c3d',5,EV,R,M,4,diff,19
445,485,40,1.212100873,0.695580228,240,338,1,1,'01_26_05.c3d',5,EV,R,M,5,diff,98
878,1694,816,0.581642786,0.600213732,1397,748,407,1,'01_26_01.c3d',6,EV,R,M,1,diff,649
724,1570,846,1.428119314,0.847618942,1161,598,1,1,'01_26_02.c3d',6,EV,R,M,2,diff,563
821,1390,569,1.030958889,0.719537089,709,651,1,1,'01_26_03.c3d',6,EV,R,M,3,diff,58
759,1279,520,1.010456032,0.651207469,881,634,1,1,'01_26_04.c3d',6,EV,R,M,4,diff,247
850,1141,291,0.820828401,0.507781548,529,671,285,1,'01_26_05.c3d',6,EV,R,M,5,diff,142
1442,2355,913,0.474674368,0.31381762,1867,1120,135,1,'01_26_01.c3d',7,EV,R,M,1,diff,747
1451,1521,70,1.233578885,0.248561292,873,1054,1,1,'01_26_02.c3d',7,EV,R,M,2,diff,181
737,979,242,1.325309435,0.445736926,462,397,1,1,'01_26_03.c3d',7,EV,R,M,3,diff,65
781,1116,335,1.033213261,0.416240646,466,588,3,1,'01_26_04.c3d',7,EV,R,M,4,diff,122
722,986,264,1.45139536,0.46002688,495,622,158,1,'01_26_05.c3d',7,EV,R,M,5,diff,127
986,2099,1113,0.649221064,0.400625026,478,818,96,1,'01_26_01.c3d',8,EV,R,M,1,diff,340
666,1061,395,0.748648958,0.470023204,470,433,1,1,'01_26_02.c3d',8,EV,R,M,2,diff,37
829,1158,329,1.066212321,0.498733601,434,538,1,1,'01_26_03.c3d',8,EV,R,M,3,diff,104
898,1396,498,0.809731739,0.48626472,523,713,289,302,'01_26_04.c3d',8,EV,R,M,4,diff,190
775,1338,563,0.836392514,0.495755774,444,569,1,1,'01_26_05.c3d',8,EV,R,M,5,diff,125
918,1906,988,1.033744507,0.486355743,507,452,285,246,'01_26_01.c3d',9,EV,R,M,1,diff,55
717,1449,732,1.38808139,0.649600828,442,515,166,1,'01_26_02.c3d',9,EV,R,M,2,diff,73
828,1921,1093,0.892513194,0.612853364,1626,608,1,293,'01_26_03.c3d',9,EV,R,M,3,diff,1018
917,1742,825,1.01040307,0.503653578,526,575,320,264,'01_26_04.c3d',9,EV,R,M,4,diff,49
998,1780,782,1.146191179,0.385525961,1460,753,264,242,'01_26_05.c3d',9,EV,R,M,5,diff,707
877,1795,918,1.317004818,0.568893321,491,565,321,312,'01_26_01.c3d',10,EV,R,M,1,diff,74
703,1557,854,1.504004725,0.792098843,461,581,285,267,'01_26_02.c3d',10,EV,R,M,2,diff,120
756,1378,622,1.40920365,0.783259582,573,642,1,71,'01_26_03.c3d',10,EV,R,M,3,diff,69
833,1514,681,1.188111025,0.732802207,429,536,241,253,'01_26_04.c3d',10,EV,R,M,4,diff,107
870,909,39,1.456841149,1.07675799,393,301,41,13,'01_26_05.c3d',10,EV,R,M,5,diff,92
897,953,56,1.029094355,0.571548705,564,846,1,1,'01_26_01.c3d',11,EV,R,M,1,diff,282
1093,1513,420,0.768750325,0.427668255,567,958,1,34,'01_26_02.c3d',11,EV,R,M,2,diff,391
1128,2410,1282,0.587247894,0.456555745,2201,933,1,1,'01_26_03.c3d',11,EV,R,M,3,diff,1268
1128,1856,728,0.516007617,0.34674582,606,1058,24,242,'01_26_04.c3d',11,EV,R,M,4,diff,452
1039,2072,1033,0.501151925,0.412171513,634,893,351,336,'01_26_05.c3d',11,EV,R,M,5,diff,259
841,1407,566,1.135486359,0.450548098,514,597,317,293,'01_26_01.c3d',12,EV,R,M,1,diff,83
646,1639,993,1.568621969,0.641150559,425,541,251,1,'01_26_02.c3d',12,EV,R,M,2,diff,116
923,941,18,1.433345723,0.389708564,458,787,275,112,'01_26_03.c3d',12,EV,R,M,3,diff,329
678,1346,668,0.990327793,0.577850605,464,442,101,58,'01_26_04.c3d',12,EV,R,M,4,diff,22
652,769,117,1.657317476,0.638412178,371,416,167,119,'01_26_05.c3d',12,EV,R,M,5,diff,45
762,964,202,1.73324148,0.627639826,499,678,1,1,'01_26_01.c3d',13,EV,R,M,1,diff,179
636,671,35,1.540200916,0.546947458,489,420,5,1,'01_26_02.c3d',13,EV,R,M,2,diff,69
868,914,46,1.821031816,0.691241515,654,749,445,1,'01_26_03.c3d',13,EV,R,M,3,diff,95
747,951,204,1.726181378,0.668085779,448,514,227,1,'01_26_04.c3d',13,EV,R,M,4,diff,66
913,1333,420,1.28168315,0.598924136,561,643,284,262,'01_26_05.c3d',13,EV,R,M,5,diff,82
687,784,97,2.052340168,0.993031407,429,529,261,1,'01_26_01.c3d',14,EV,R,M,1,diff,100
756,887,131,1.961399648,0.960315964,389,424,232,1,'01_26_02.c3d',14,EV,R,M,2,diff,35
623,1173,550,2.666269024,0.934979075,459,561,291,1,'01_26_03.c3d',14,EV,R,M,3,diff,102
764,1071,307,1.913624519,0.818773582,391,561,238,1,'01_26_04.c3d',14,EV,R,M,4,diff,170
700,1469,769,1.985554579,0.909556075,561,623,42,340,'01_26_05.c3d',14,EV,R,M,5,diff,62
772,961,189,1.717643467,0.508536836,528,701,55,297,'01_26_01.c3d',15,EV,R,M,1,diff,173
784,1023,239,1.393393785,0.602614859,506,651,48,26,'01_26_02.c3d',15,EV,R,M,2,diff,145
736,870,134,1.399533098,0.612114897,473,644,268,273,'01_26_03.c3d',15,EV,R,M,3,diff,171
819,1806,987,1.40873628,0.678319989,563,755,1,362,'01_26_04.c3d',15,EV,R,M,4,diff,192
731,1227,496,1.305848885,0.659658177,462,670,266,1,'01_26_05.c3d',15,EV,R,M,5,diff,208
870,958,88,1.58046792,0.547782299,432,756,233,175,'01_26_01.c3d',16,EV,R,M,1,diff,324
755,810,55,1.550845853,0.87766372,521,616,287,260,'01_26_02.c3d',16,EV,R,M,2,diff,95
785,1948,1163,1.099234389,0.647637641,833,689,158,1,'01_26_03.c3d',16,EV,R,M,3,diff,144
902,979,77,1.157984085,1.28386593,50,1,1,1,'01_26_04.c3d',16,EV,R,M,4,diff,49
902,1084,182,1.672728478,0.66454654,512,689,1,1,'01_26_05.c3d',16,EV,R,M,5,diff,177
699,1134,435,2.63021809,1.039414061,574,532,420,1,'01_26_01.c3d',17,EV,R,M,1,diff,42
672,1018,346,2.538539772,0.978105067,406,366,263,256,'01_26_02.c3d',17,EV,R,M,2,diff,40
625,719,94,3.159469881,0.884972451,472,460,322,315,'01_26_03.c3d',17,EV,R,M,3,diff,12
431,989,558,3.522048225,1.388923685,365,328,231,218,'01_26_04.c3d',17,EV,R,M,4,diff,37
621,625,4,2.115353809,0.662472703,409,425,249,232,'01_26_05.c3d',17,EV,R,M,5,diff,16
1027,1933,906,1.547166995,0.838823967,570,688,136,1,'01_26_01.c3d',18,EV,R,M,1,diff,118
755,2342,1587,1.886022937,1.116584221,453,581,1,1,'01_26_02.c3d',18,EV,R,M,2,diff,128
937,1237,300,2.104947602,0.819807064,538,568,1,263,'01_26_03.c3d',18,EV,R,M,3,diff,30
1096,1097,1,1.054830973,0.801926509,296,445,1,1,'01_26_04.c3d',18,EV,R,M,4,diff,149
417,1284,867,1.115864538,0.685807747,401,396,1,1,'01_26_05.c3d',18,EV,R,M,5,diff,5
803,1377,574,1.286436013,0.656278556,489,635,303,291,'01_26_01.c3d',19,EV,R,M,1,diff,146
765,1144,379,1.100378603,0.661281761,575,659,1,1,'01_26_02.c3d',19,EV,R,M,2,diff,84
697,1222,525,1.346864849,0.804906791,520,653,1,1,'01_26_03.c3d',19,EV,R,M,3,diff,133
722,904,182,1.223565197,0.639642778,507,493,137,1,'01_26_04.c3d',19,EV,R,M,4,diff,14
865,1075,210,1.33480359,0.530305695,469,736,1,1,'01_26_05.c3d',19,EV,R,M,5,diff,267
787,1055,268,1.12968057,0.636380811,521,591,256,1,'01_26_01.c3d',20,EV,R,M,1,diff,70
714,1046,332,1.794640325,0.752014025,438,573,261,257,'01_26_02.c3d',20,EV,R,M,2,diff,135
743,1388,645,1.597224884,0.658383798,459,560,90,1,'01_26_03.c3d',20,EV,R,M,3,diff,101
907,1584,677,0.709713563,0.484464197,455,712,252,256,'01_26_04.c3d',20,EV,R,M,4,diff,257
814,1410,596,1.003979855,0.606121606,473,686,1,1,'01_26_05.c3d',20,EV,R,M,5,diff,213
770,1474,704,0.969970257,0.6281062,763,707,379,1,'01_26_01.c3d',21,EV,R,M,1,diff,56
885,1104,219,1.242551596,0.570403603,550,692,332,295,'01_26_02.c3d',21,EV,R,M,2,diff,142
911,1375,464,1.306520333,0.529354105,551,651,360,1,'01_26_03.c3d',21,EV,R,M,3,diff,100
1384,1395,11,0.724533006,0.263335897,899,859,1,1,'01_26_04.c3d',21,EV,R,M,4,diff,40
833,1137,304,1.238806186,0.555123392,490,588,259,242,'01_26_05.c3d',21,EV,R,M,5,diff,98
1149,1682,533,0.912603722,0.530548347,554,928,1,359,'01_26_01.c3d',22,EV,R,M,1,diff,374
865,1505,640,0.869036011,0.7218699,531,698,120,322,'01_26_02.c3d',22,EV,R,M,2,diff,167
941,1501,560,0.695427602,0.601008216,749,767,5,1,'01_26_03.c3d',22,EV,R,M,3,diff,18
852,1361,509,0.768727264,0.722760871,971,621,1,1,'01_26_04.c3d',22,EV,R,M,4,diff,350
838,1442,604,0.902742175,0.727235456,462,619,1,218,'01_26_05.c3d',22,EV,R,M,5,diff,157
956,2669,1713,0.649808324,0.545956503,1410,815,126,284,'01_26_01.c3d',23,EV,R,M,1,diff,595
1058,2713,1655,0.617338701,0.442884073,1092,840,271,1,'01_26_02.c3d',23,EV,R,M,2,diff,252
991,1944,953,0.809834292,0.471112125,494,820,1,1,'01_26_03.c3d',23,EV,R,M,3,diff,326
1086,3950,2864,0.581650731,0.464584681,552,943,39,283,'01_26_04.c3d',23,EV,R,M,4,diff,391
1078,2439,1361,0.435405928,0.376799782,1001,781,20,169,'01_26_05.c3d',23,EV,R,M,5,diff,220
908,957,49,1.924641659,0.550199507,547,538,351,1,'01_26_01.c3d',24,EV,R,M,1,diff,9
685,801,116,1.617193501,0.56667021,398,388,199,1,'01_26_02.c3d',24,EV,R,M,2,diff,10
856,944,88,1.353622556,0.391643614,476,701,239,1,'01_26_03.c3d',24,EV,R,M,3,diff,225
846,886,40,1.367406364,0.472427313,452,590,1,56,'01_26_04.c3d',24,EV,R,M,4,diff,138
688,717,29,1.521297357,0.473075908,315,531,103,84,'01_26_05.c3d',24,EV,R,M,5,diff,216
950,1993,1043,1.222762942,0.481603687,671,861,459,348,'01_26_01.c3d',25,EV,R,M,1,diff,190
969,1642,673,1.427406117,0.633051174,718,832,483,460,'01_26_02.c3d',25,EV,R,M,2,diff,114
701,1096,395,1.168309554,0.602506363,548,565,29,1,'01_26_03.c3d',25,EV,R,M,3,diff,17
899,2335,1436,1.143922052,0.557871049,655,758,409,248,'01_26_04.c3d',25,EV,R,M,4,diff,103
843,1256,413,1.089531949,0.477993808,496,626,272,164,'01_26_05.c3d',25,EV,R,M,5,diff,130
950,1129,179,1.167154233,0.403501117,610,688,348,1,'01_26_01.c3d',26,EV,R,M,1,diff,78
1124,1166,42,0.948093004,0.305669946,658,1157,285,242,'01_26_02.c3d',26,EV,R,M,2,diff,499
1234,1519,285,1.018485878,0.249733111,603,788,1,1,'01_26_03.c3d',26,EV,R,M,3,diff,185
907,1152,245,1.07374777,0.322156349,502,668,266,33,'01_26_04.c3d',26,EV,R,M,4,diff,166
948,2099,1151,0.636307058,0.347392648,454,786,257,266,'01_26_05.c3d',26,EV,R,M,5,diff,332
1192,1721,529,0.747691098,0.440736352,633,794,1,1,'01_26_01.c3d',27,EV,R,M,1,diff,161
1488,1650,162,0.673759523,0.369362491,677,973,444,453,'01_26_02.c3d',27,EV,R,M,2,diff,296
1253,1561,308,0.92006147,0.495779713,999,991,1,458,'01_26_03.c3d',27,EV,R,M,3,diff,8
1211,1668,457,0.652692871,0.505625238,791,757,5,1,'01_26_04.c3d',27,EV,R,M,4,diff,34
1070,1616,546,0.698287104,0.513634024,663,870,371,361,'01_26_05.c3d',27,EV,R,M,5,diff,207
1147,3075,1928,0.744297956,0.46983763,2189,798,1,1,'01_26_01.c3d',28,EV,R,M,1,diff,1391
1645,1658,13,1.06612337,0.346227211,913,1112,54,1,'01_26_02.c3d',28,EV,R,M,2,diff,199
947,1513,566,0.718070497,0.492858,821,773,226,1,'01_26_03.c3d',28,EV,R,M,3,diff,48
916,1798,882,0.842130355,0.566347554,538,805,249,1,'01_26_04.c3d',28,EV,R,M,4,diff,267
1181,2333,1152,0.632606401,0.406044253,1866,727,1,1,'01_26_05.c3d',28,EV,R,M,5,diff,1139
901,1111,210,1.706410106,0.717706639,649,704,422,1,'01_26_01.c3d',29,EV,R,M,1,diff,55
1172,1233,61,1.800857787,0.685925581,727,858,506,467,'01_26_02.c3d',29,EV,R,M,2,diff,131
880,1041,161,1.28230844,0.512227276,507,649,1,1,'01_26_03.c3d',29,EV,R,M,3,diff,142
798,1436,638,1.214101677,0.591297065,529,678,307,1,'01_26_04.c3d',29,EV,R,M,4,diff,149
732,882,150,1.314621737,0.60089642,455,575,57,83,'01_26_05.c3d',29,EV,R,M,5,diff,120
747,1403,656,1.086205531,0.590855362,523,654,1,1,'01_26_01.c3d',30,EV,R,M,1,diff,131
696,935,239,0.901634422,0.480464638,453,567,136,1,'01_26_02.c3d',30,EV,R,M,2,diff,114
930,1820,890,0.688245363,0.413429258,524,777,1,1,'01_26_03.c3d',30,EV,R,M,3,diff,253
810,1373,563,0.787834631,0.392748183,473,691,54,1,'01_26_04.c3d',30,EV,R,M,4,diff,218
909,1523,614,0.827354827,0.397566864,578,610,188,1,'01_26_05.c3d',30,EV,R,M,5,diff,32
667,1117,450,2.197221361,1.119599418,532,566,352,1,'01_26_01.c3d',31,EV,R,M,1,diff,34
711,1434,723,2.09057569,0.941107381,507,601,297,281,'01_26_02.c3d',31,EV,R,M,2,diff,94
826,1420,594,2.007810058,0.844964658,526,618,344,325,'01_26_03.c3d',31,EV,R,M,3,diff,92
710,946,236,2.351430206,0.862171,499,556,297,287,'01_26_04.c3d',31,EV,R,M,4,diff,57
772,1245,473,1.993756575,0.864366967,570,657,355,337,'01_26_05.c3d',31,EV,R,M,5,diff,87
1109,1158,49,1.462439797,0.640830044,779,988,1,555,'01_26_01.c3d',32,EV,R,M,1,diff,209
886,982,96,1.679319315,0.60311206,520,704,296,29,'01_26_02.c3d',32,EV,R,M,2,diff,184
931,1253,322,1.07500029,0.562613613,700,809,323,296,'01_26_03.c3d',32,EV,R,M,3,diff,109
1305,1396,91,1.160925986,0.61793361,722,1120,334,18,'01_26_04.c3d',32,EV,R,M,4,diff,398
1196,1505,309,1.273442507,0.633888194,676,885,76,1,'01_26_05.c3d',32,EV,R,M,5,diff,209
1001,1389,388,0.927894592,0.641223519,583,819,358,1,'01_26_01.c3d',33,EV,R,M,1,diff,236
834,1738,904,0.896276681,0.680411922,661,758,102,321,'01_26_02.c3d',33,EV,R,M,2,diff,97
846,2047,1201,1.24628031,0.639025111,523,741,304,1,'01_26_03.c3d',33,EV,R,M,3,diff,218
858,1070,212,1.332211396,0.636570096,612,777,1,328,'01_26_04.c3d',33,EV,R,M,4,diff,165
980,993,13,1.46933472,0.61328926,568,730,335,1,'01_26_05.c3d',33,EV,R,M,5,diff,162
853,1018,165,1.472424457,0.557769635,543,665,341,319,'01_26_01.c3d',34,EV,R,M,1,diff,122
760,1780,1020,1.850139435,0.906050137,664,744,459,1,'01_26_02.c3d',34,EV,R,M,2,diff,80
780,801,21,1.322487212,0.577873172,495,605,1,234,'01_26_03.c3d',34,EV,R,M,3,diff,110
788,1501,713,1.023240855,0.549455782,547,736,1,306,'01_26_04.c3d',34,EV,R,M,4,diff,189
788,1021,233,0.981463268,0.568673855,1002,675,311,1,'01_26_05.c3d',34,EV,R,M,5,diff,327
807,998,191,2.132584017,0.663461449,503,638,306,260,'01_26_01.c3d',35,EV,R,M,1,diff,135
729,954,225,1.832018614,0.603988806,402,465,213,1,'01_26_02.c3d',35,EV,R,M,2,diff,63
762,954,192,1.453471951,0.503765589,433,459,40,1,'01_26_03.c3d',35,EV,R,M,3,diff,26
762,869,107,1.58505942,0.57397476,410,526,96,110,'01_26_04.c3d',35,EV,R,M,4,diff,116
653,1008,355,1.751501509,0.756170038,386,515,180,222,'01_26_05.c3d',35,EV,R,M,5,diff,129
1841,1972,131,0.792139449,0.679789534,524,813,298,1,'01_27_01.c3d',1,EV,R,H,1,diff,289
1340,2041,701,0.558622375,0.362843384,1020,878,1,1,'01_27_02.c3d',1,EV,R,H,2,diff,142
1000,2360,1360,1.480243985,0.451559632,529,946,282,1,'01_27_03.c3d',1,EV,R,H,3,diff,417
1205,1242,37,0.935409535,0.3937619,406,806,226,248,'01_27_04.c3d',1,EV,R,H,4,diff,400
825,1057,232,1.412573565,0.43102054,538,543,1,1,'01_27_05.c3d',1,EV,R,H,5,diff,5
961,1341,380,0.742628292,0.447813688,512,756,1,1,'01_27_01.c3d',2,EV,R,H,1,diff,244
853,2424,1571,1.194097753,0.575325125,527,749,1,228,'01_27_02.c3d',2,EV,R,H,2,diff,222
944,1069,125,0.888638748,0.437861872,479,733,97,150,'01_27_03.c3d',2,EV,R,H,3,diff,254
1098,3031,1933,1.0771815,0.517098634,645,798,1,1,'01_27_04.c3d',2,EV,R,H,4,diff,153
1015,1093,78,0.82199195,0.454702351,617,774,22,1,'01_27_05.c3d',2,EV,R,H,5,diff,157
654,1198,544,1.428092395,0.949417909,341,363,1,1,'01_27_01.c3d',3,EV,R,H,1,diff,22
686,857,171,1.377207454,0.578269433,501,498,28,1,'01_27_02.c3d',3,EV,R,H,2,diff,3
830,1544,714,1.94659222,0.442414511,427,704,265,1,'01_27_03.c3d',3,EV,R,H,3,diff,277
733,899,166,1.651995839,0.728825663,518,484,222,1,'01_27_04.c3d',3,EV,R,H,4,diff,34
737,782,45,1.580265869,0.6168743,416,480,195,1,'01_27_05.c3d',3,EV,R,H,5,diff,64
828,1010,182,1.243053286,0.565862977,590,739,320,1,'01_27_01.c3d',4,EV,R,H,1,diff,149
851,1007,156,1.094888064,0.482854535,521,633,260,1,'01_27_02.c3d',4,EV,R,H,2,diff,112
859,1142,283,1.23955068,0.493375918,467,706,181,237,'01_27_03.c3d',4,EV,R,H,3,diff,239
818,1017,199,1.003541064,0.446722966,592,585,35,1,'01_27_04.c3d',4,EV,R,H,4,diff,7
994,1116,122,1.101080345,0.463296349,605,769,1,305,'01_27_05.c3d',4,EV,R,H,5,diff,164
569,820,251,3.188105641,1.016531698,416,386,282,1,'01_27_01.c3d',5,EV,R,H,1,diff,30
576,1250,674,3.119112931,0.873298869,399,394,262,232,'01_27_02.c3d',5,EV,R,H,2,diff,5
635,641,6,1.695946185,0.642822822,365,407,25,1,'01_27_03.c3d',5,EV,R,H,3,diff,42
868,915,47,2.207713565,0.874776338,508,575,1,1,'01_27_04.c3d',5,EV,R,H,4,diff,67
630,1667,1037,2.011202093,0.875890878,459,485,262,63,'01_27_05.c3d',5,EV,R,H,5,diff,26
897,1459,562,1.392401509,0.567016229,928,648,140,12,'01_27_01.c3d',6,EV,R,H,1,diff,280
807,1548,741,0.996495559,0.579009237,1543,553,1,1,'01_27_02.c3d',6,EV,R,H,2,diff,990
726,1582,856,1.525271245,0.563607133,1125,609,672,1,'01_27_03.c3d',6,EV,R,H,3,diff,516
825,1401,576,0.895113776,0.551033456,817,629,1,1,'01_27_04.c3d',6,EV,R,H,4,diff,188
736,1566,830,0.879089685,0.625334908,837,568,273,1,'01_27_05.c3d',6,EV,R,H,5,diff,269
964,1765,801,1.138611328,0.356740423,597,849,26,1,'01_27_01.c3d',7,EV,R,H,1,diff,252
1054,1880,826,1.079502048,0.410109968,713,802,513,1,'01_27_02.c3d',7,EV,R,H,2,diff,89
922,1166,244,1.079450681,0.400587288,558,742,1,1,'01_27_03.c3d',7,EV,R,H,3,diff,184
862,1143,281,1.431544677,0.387960617,464,632,258,1,'01_27_04.c3d',7,EV,R,H,4,diff,168
930,1536,606,1.247958525,0.253392055,476,338,1,1,'01_27_05.c3d',7,EV,R,H,5,diff,138
1028,1785,757,0.89916367,0.456470475,555,934,1,326,'01_27_01.c3d',8,EV,R,H,1,diff,379
916,1669,753,1.371683323,0.503621513,562,822,20,331,'01_27_02.c3d',8,EV,R,H,2,diff,260
958,2034,1076,1.108017684,0.470055761,570,702,331,1,'01_27_03.c3d',8,EV,R,H,3,diff,132
924,2028,1104,1.387960462,0.529909146,587,749,1,1,'01_27_04.c3d',8,EV,R,H,4,diff,162
947,2042,1095,0.736186175,0.529285294,536,881,289,15,'01_27_05.c3d',8,EV,R,H,5,diff,345
809,1631,822,0.871284978,0.538806319,447,507,246,1,'01_27_01.c3d',9,EV,R,H,1,diff,60
816,1747,931,1.263416235,0.594806876,533,636,366,355,'01_27_02.c3d',9,EV,R,H,2,diff,103
863,1674,811,1.12379771,0.44415552,416,531,228,205,'01_27_03.c3d',9,EV,R,H,3,diff,115
1011,1494,483,1.26561558,0.473379822,594,678,38,1,'01_27_04.c3d',9,EV,R,H,4,diff,84
791,1647,856,0.935557006,0.535433487,1308,631,319,1,'01_27_05.c3d',9,EV,R,H,5,diff,677
795,1086,291,2.076807079,0.881338721,477,543,292,263,'01_27_01.c3d',10,EV,R,H,1,diff,66
766,1624,858,1.399092263,0.588649059,416,555,237,1,'01_27_02.c3d',10,EV,R,H,2,diff,139
644,1048,404,1.305958544,0.655288628,398,438,76,92,'01_27_03.c3d',10,EV,R,H,3,diff,40
744,1382,638,0.972999957,0.642618558,430,595,129,1,'01_27_04.c3d',10,EV,R,H,4,diff,165
605,1016,411,2.318326504,1.057707416,473,538,296,287,'01_27_05.c3d',10,EV,R,H,5,diff,65
1210,2557,1347,1.530484391,0.674370887,511,755,306,1,'01_27_01.c3d',11,EV,R,H,1,diff,244
1111,1806,695,0.638553009,0.38211677,597,959,327,308,'01_27_02.c3d',11,EV,R,H,2,diff,362
1249,2149,900,0.557681235,0.388118015,1994,1070,1,1,'01_27_03.c3d',11,EV,R,H,3,diff,924
1292,2153,861,0.506527972,0.331061735,1088,1081,20,1,'01_27_04.c3d',11,EV,R,H,4,diff,7
1212,2329,1117,0.471427453,0.364762292,1899,979,61,1,'01_27_05.c3d',11,EV,R,H,5,diff,920
858,1211,353,1.303926385,0.490219958,434,746,250,258,'01_27_01.c3d',12,EV,R,H,1,diff,312
893,1593,700,0.981810026,0.466502281,543,565,329,309,'01_27_02.c3d',12,EV,R,H,2,diff,22
874,1652,778,1.323641295,0.469865725,486,730,1,302,'01_27_03.c3d',12,EV,R,H,3,diff,244
683,705,22,1.74418081,0.582202364,456,548,228,1,'01_27_04.c3d',12,EV,R,H,4,diff,92
707,710,3,1.858979274,0.53874471,405,395,258,1,'01_27_05.c3d',12,EV,R,H,5,diff,10
1182,1187,5,1.315273487,0.460037875,634,951,1,1,'01_27_01.c3d',13,EV,R,H,1,diff,317
978,1067,89,1.843677281,0.565051437,535,714,22,1,'01_27_02.c3d',13,EV,R,H,2,diff,179
812,1111,299,1.643172587,0.570835831,554,606,215,1,'01_27_03.c3d',13,EV,R,H,3,diff,52
866,1742,876,1.362254145,0.553005008,505,604,310,1,'01_27_04.c3d',13,EV,R,H,4,diff,99
803,1835,1032,1.236446193,0.608480266,519,609,302,1,'01_27_05.c3d',13,EV,R,H,5,diff,90
746,847,101,2.551943888,0.844866261,416,517,65,238,'01_27_01.c3d',14,EV,R,H,1,diff,101
712,755,43,2.175056195,0.696906772,335,337,61,114,'01_27_02.c3d',14,EV,R,H,2,diff,2
754,771,17,1.709557802,0.699144444,370,426,1,1,'01_27_03.c3d',14,EV,R,H,3,diff,56
731,792,61,1.859881401,0.514557616,363,514,35,38,'01_27_04.c3d',14,EV,R,H,4,diff,151
678,810,132,1.89485742,0.665710998,410,510,248,1,'01_27_05.c3d',14,EV,R,H,5,diff,100
915,953,38,1.651344282,0.540833134,509,609,1,24,'01_27_01.c3d',15,EV,R,H,1,diff,100
865,1004,139,1.530431008,0.596108632,474,578,275,1,'01_27_02.c3d',15,EV,R,H,2,diff,104
756,879,123,1.223289865,0.52649776,387,557,113,1,'01_27_03.c3d',15,EV,R,H,3,diff,170
896,2249,1353,1.510817207,0.579452575,568,739,213,1,'01_27_04.c3d',15,EV,R,H,4,diff,171
799,1724,925,1.332739934,0.479816412,496,639,188,97,'01_27_05.c3d',15,EV,R,H,5,diff,143
660,1253,593,1.660394053,0.795792295,472,523,275,1,'01_27_01.c3d',16,EV,R,H,1,diff,51
1079,1966,887,1.378911338,0.492091358,537,807,51,1,'01_27_02.c3d',16,EV,R,H,2,diff,270
778,972,194,1.152671034,0.576662272,444,744,43,228,'01_27_03.c3d',16,EV,R,H,3,diff,300
743,1450,707,1.223578735,0.613335158,457,601,1,1,'01_27_04.c3d',16,EV,R,H,4,diff,144
812,1479,667,1.475358286,0.645400663,417,646,236,82,'01_27_05.c3d',16,EV,R,H,5,diff,229
581,750,169,3.239504184,0.787043286,394,427,251,1,'01_27_01.c3d',17,EV,R,H,1,diff,33
606,625,19,2.471937333,0.831359522,441,539,291,1,'01_27_02.c3d',17,EV,R,H,2,diff,98
598,913,315,2.27697745,0.853500624,428,512,253,251,'01_27_03.c3d',17,EV,R,H,3,diff,84
665,687,22,2.016069693,0.746452845,531,594,269,243,'01_27_04.c3d',17,EV,R,H,4,diff,63
584,868,284,2.839567794,1.008695821,429,492,300,1,'01_27_05.c3d',17,EV,R,H,5,diff,63
1073,2017,944,2.269380406,0.828346193,508,610,313,1,'01_27_01.c3d',18,EV,R,H,1,diff,102
1406,1938,532,1.664256519,0.947797968,505,669,49,289,'01_27_02.c3d',18,EV,R,H,2,diff,164
721,754,33,2.262945682,0.687582914,434,553,148,248,'01_27_03.c3d',18,EV,R,H,3,diff,119
804,828,24,1.625756091,0.550039694,463,571,264,255,'01_27_04.c3d',18,EV,R,H,4,diff,108
1169,1584,415,1.230858943,0.716672405,471,399,1,1,'01_27_05.c3d',18,EV,R,H,5,diff,72
901,1272,371,0.82191169,0.534613161,474,701,270,254,'01_27_01.c3d',19,EV,R,H,1,diff,227
849,1377,528,0.773398703,0.575814937,514,740,1,255,'01_27_02.c3d',19,EV,R,H,2,diff,226
726,830,104,1.80944131,0.585893067,420,533,230,212,'01_27_03.c3d',19,EV,R,H,3,diff,113
742,1178,436,1.09277896,0.625704176,468,603,226,1,'01_27_04.c3d',19,EV,R,H,4,diff,135
1223,1811,588,1.080704618,0.555701067,638,705,26,258,'01_27_05.c3d',19,EV,R,H,5,diff,67
822,1530,708,1.03438573,0.608658605,459,640,281,248,'01_27_01.c3d',20,EV,R,H,1,diff,181
819,2242,1423,1.449222994,0.593379771,512,656,340,1,'01_27_02.c3d',20,EV,R,H,2,diff,144
764,1180,416,1.695802159,0.641696993,472,580,313,1,'01_27_03.c3d',20,EV,R,H,3,diff,108
898,1266,368,1.063376325,0.448616624,465,603,1,1,'01_27_04.c3d',20,EV,R,H,4,diff,138
836,1642,806,1.325291518,0.590765205,478,657,25,1,'01_27_05.c3d',20,EV,R,H,5,diff,179
918,1490,572,1.175473807,0.505503677,580,831,1,18,'01_27_01.c3d',21,EV,R,H,1,diff,251
1042,1214,172,1.333771384,0.433040332,532,925,324,1,'01_27_02.c3d',21,EV,R,H,2,diff,393
814,1636,822,0.619887187,0.450957678,339,655,20,1,'01_27_03.c3d',21,EV,R,H,3,diff,316
1077,1845,768,0.651169496,0.357608651,550,856,68,239,'01_27_04.c3d',21,EV,R,H,4,diff,306
946,1118,172,1.005558115,0.424342138,519,611,62,261,'01_27_05.c3d',21,EV,R,H,5,diff,92
1365,2331,966,0.595221088,0.406921289,657,1093,1,1,'01_27_01.c3d',22,EV,R,H,1,diff,436
885,1670,785,0.657166779,0.768606426,1373,750,329,1,'01_27_02.c3d',22,EV,R,H,2,diff,623
948,1695,747,0.654992133,0.672711309,1345,753,8,50,'01_27_03.c3d',22,EV,R,H,3,diff,592
1164,1992,828,0.732198828,0.5869539,1574,946,529,1,'01_27_04.c3d',22,EV,R,H,4,diff,628
1052,1517,465,0.928772991,0.536645059,566,742,278,290,'01_27_05.c3d',22,EV,R,H,5,diff,176
1144,2586,1442,0.447195314,0.459820918,1684,1050,23,354,'01_27_01.c3d',23,EV,R,H,1,diff,634
1180,3912,2732,0.553861426,0.457986632,866,962,45,168,'01_27_02.c3d',23,EV,R,H,2,diff,96
1584,1781,197,0.568709256,0.368236316,507,758,1,27,'01_27_03.c3d',23,EV,R,H,3,diff,251
1823,1933,110,0.571462459,0.338966495,922,756,60,210,'01_27_04.c3d',23,EV,R,H,4,diff,166
1760,3618,1858,0.3680612,0.336875618,1805,1352,1,1,'01_27_05.c3d',23,EV,R,H,5,diff,453
848,931,83,1.195513355,0.443371964,438,583,231,144,'01_27_01.c3d',24,EV,R,H,1,diff,145
954,984,30,1.166173258,0.397704168,497,623,268,1,'01_27_02.c3d',24,EV,R,H,2,diff,126
701,870,169,0.852191925,0.459906001,498,411,1,1,'01_27_03.c3d',24,EV,R,H,3,diff,87
923,941,18,1.143708326,0.414798823,469,639,206,1,'01_27_04.c3d',24,EV,R,H,4,diff,170
881,887,6,1.341342734,0.44764893,460,614,243,3,'01_27_05.c3d',24,EV,R,H,5,diff,154
631,2188,1557,1.595804706,0.76797124,423,554,223,221,'01_27_01.c3d',25,EV,R,H,1,diff,131
757,954,197,1.201040219,0.534583987,395,558,1,1,'01_27_02.c3d',25,EV,R,H,2,diff,163
736,933,197,1.293898953,0.528146154,459,573,216,1,'01_27_03.c3d',25,EV,R,H,3,diff,114
759,1267,508,1.02435904,0.577499462,473,535,1,233,'01_27_04.c3d',25,EV,R,H,4,diff,62
919,3193,2274,0.936581163,0.450009862,659,769,1,304,'01_27_05.c3d',25,EV,R,H,5,diff,110
1335,1469,134,1.021097144,0.281411232,459,904,273,1,'01_27_01.c3d',26,EV,R,H,1,diff,445
1017,1665,648,0.741299659,0.334516927,1205,503,311,288,'01_27_02.c3d',26,EV,R,H,2,diff,702
1096,1831,735,0.684460409,0.416875893,560,694,361,1,'01_27_03.c3d',26,EV,R,H,3,diff,134
905,3434,2529,0.787105088,0.415355668,1381,752,383,1,'01_27_04.c3d',26,EV,R,H,4,diff,629
1047,2021,974,0.528389453,0.26204815,809,697,2,1,'01_27_05.c3d',26,EV,R,H,5,diff,112
1250,1629,379,1.172193338,0.510752239,675,1005,1,1,'01_27_01.c3d',27,EV,R,H,1,diff,330
1289,2120,831,0.709829333,0.506850382,1101,1069,442,1,'01_27_02.c3d',27,EV,R,H,2,diff,32
1508,2124,616,0.807704338,0.468319693,1167,1033,1,496,'01_27_03.c3d',27,EV,R,H,3,diff,134
924,1463,539,1.189285362,0.655166926,545,800,201,1,'01_27_04.c3d',27,EV,R,H,4,diff,255
1100,1471,371,0.853376208,0.506879859,580,881,38,364,'01_27_05.c3d',27,EV,R,H,5,diff,301
1067,1747,680,0.627526716,0.420662232,622,804,291,270,'01_27_01.c3d',28,EV,R,H,1,diff,182
1239,1277,38,0.806335731,0.425669359,832,1001,1,1,'01_27_02.c3d',28,EV,R,H,2,diff,169
929,1374,445,0.88495046,0.614325375,564,841,278,1,'01_27_03.c3d',28,EV,R,H,3,diff,277
889,2249,1360,0.979691986,0.588981414,453,792,1,244,'01_27_04.c3d',28,EV,R,H,4,diff,339
1004,1542,538,0.884380428,0.517973609,870,934,25,1,'01_27_05.c3d',28,EV,R,H,5,diff,64
793,995,202,1.750264126,0.619837008,509,609,282,1,'01_27_01.c3d',29,EV,R,H,1,diff,100
683,1663,980,2.047722447,0.742936551,463,607,259,1,'01_27_02.c3d',29,EV,R,H,2,diff,144
902,1301,399,1.106590051,0.47293665,466,592,1,241,'01_27_03.c3d',29,EV,R,H,3,diff,126
919,1308,389,0.998059247,0.410564472,479,645,250,1,'01_27_04.c3d',29,EV,R,H,4,diff,166
922,1502,580,1.117927903,0.441099375,479,673,263,242,'01_27_05.c3d',29,EV,R,H,5,diff,194
737,1526,789,1.284231549,0.639221779,552,678,280,1,'01_27_01.c3d',30,EV,R,H,1,diff,126
1002,1307,305,0.877004506,0.391310008,442,566,1,232,'01_27_02.c3d',30,EV,R,H,2,diff,124
885,2144,1259,0.900652224,0.412718806,471,690,225,1,'01_27_03.c3d',30,EV,R,H,3,diff,219
1035,1056,21,0.779455189,0.351285173,807,724,1,1,'01_27_04.c3d',30,EV,R,H,4,diff,83
836,1281,445,1.002092739,0.382804241,431,622,111,125,'01_27_05.c3d',30,EV,R,H,5,diff,191
1326,3604,2278,0.871196216,0.636729079,1753,1024,1,546,'01_27_01.c3d',31,EV,R,H,1,diff,729
824,1680,856,2.107610654,0.918229192,647,722,380,372,'01_27_02.c3d',31,EV,R,H,2,diff,75
672,802,130,2.209053496,0.756394982,412,445,241,211,'01_27_03.c3d',31,EV,R,H,3,diff,33
873,1007,134,1.849903648,0.578005471,485,558,272,247,'01_27_04.c3d',31,EV,R,H,4,diff,73
772,916,144,2.160518039,0.786034672,512,582,331,1,'01_27_05.c3d',31,EV,R,H,5,diff,70
1053,1373,320,1.827289549,0.441221505,548,681,66,308,'01_27_01.c3d',32,EV,R,H,1,diff,133
948,956,8,1.755637497,0.480347726,563,816,1,317,'01_27_02.c3d',32,EV,R,H,2,diff,253
982,1011,29,1.404721586,0.47020433,525,819,309,1,'01_27_03.c3d',32,EV,R,H,3,diff,294
1085,1140,55,1.021686569,0.454364396,732,744,56,261,'01_27_04.c3d',32,EV,R,H,4,diff,12
1333,1866,533,0.922166124,0.506036925,790,760,61,1,'01_27_05.c3d',32,EV,R,H,5,diff,30
1059,1991,932,0.796733418,0.529482424,1024,1023,374,384,'01_27_01.c3d',33,EV,R,H,1,diff,1
1012,2110,1098,0.953619626,0.565532164,970,968,5,398,'01_27_02.c3d',33,EV,R,H,2,diff,2
996,1868,872,1.085985069,0.538049469,538,891,281,1,'01_27_03.c3d',33,EV,R,H,3,diff,353
1089,2104,1015,0.863579575,0.496865216,934,953,361,349,'01_27_04.c3d',33,EV,R,H,4,diff,19
972,1753,781,0.948509385,0.611589072,709,833,22,343,'01_27_05.c3d',33,EV,R,H,5,diff,124
1111,1833,722,0.717560225,0.419573021,678,1042,32,1,'01_27_01.c3d',34,EV,R,H,1,diff,364
755,1040,285,1.43713927,0.592930388,458,599,288,272,'01_27_02.c3d',34,EV,R,H,2,diff,141
836,979,143,1.065307067,0.41761652,480,814,229,1,'01_27_03.c3d',34,EV,R,H,3,diff,334
868,1402,534,1.00988091,0.469810926,476,631,291,1,'01_27_04.c3d',34,EV,R,H,4,diff,155
870,1756,886,0.866683866,0.489557008,557,609,1,281,'01_27_05.c3d',34,EV,R,H,5,diff,52
770,928,158,1.839075726,0.571868353,430,643,202,205,'01_27_01.c3d',35,EV,R,H,1,diff,213
740,1076,336,1.412589171,0.529635406,435,571,190,21,'01_27_02.c3d',35,EV,R,H,2,diff,136
703,1215,512,1.374652691,0.563850475,418,377,1,1,'01_27_03.c3d',35,EV,R,H,3,diff,41
862,926,64,1.606213453,0.506049701,450,633,237,1,'01_27_04.c3d',35,EV,R,H,4,diff,183
713,1437,724,1.312954561,0.618115941,400,630,170,1,'01_27_05.c3d',35,EV,R,H,5,diff,230
1224,1417,193,1.069640356,1.253776331,1025,786,520,1,'01_28_01.c3d',1,VE,B,E,1,diff,239
1027,1029,2,0.980004805,1.422465436,610,558,266,269,'01_28_02.c3d',1,VE,B,E,2,diff,52
1046,1065,19,1.008818549,1.143864467,760,500,246,262,'01_28_03.c3d',1,VE,B,E,3,diff,260
966,1140,174,1.087991626,1.314105374,795,560,322,329,'01_28_04.c3d',1,VE,B,E,4,diff,235
1097,1323,226,1.080408898,1.590453106,809,599,294,325,'01_28_05.c3d',1,VE,B,E,5,diff,210
2434,3098,664,0.705100269,1.295228553,987,1006,402,36,'01_28_01.c3d',2,VE,B,E,1,diff,19
1659,2248,589,0.871844607,1.199221108,1429,1152,930,1,'01_28_02.c3d',2,VE,B,E,2,diff,277
1078,1406,328,0.832687144,1.331314981,689,453,258,1,'01_28_03.c3d',2,VE,B,E,3,diff,236
1397,3090,1693,0.919471004,1.476442756,719,446,1,114,'01_28_04.c3d',2,VE,B,E,4,diff,273
1152,1185,33,0.771109255,1.322422566,896,1090,262,264,'01_28_05.c3d',2,VE,B,E,5,diff,194
658,967,309,1.768937853,2.377673089,545,498,257,92,'01_28_01.c3d',3,VE,B,E,1,diff,47
820,894,74,1.065507427,1.36033796,632,478,263,218,'01_28_02.c3d',3,VE,B,E,2,diff,154
872,925,53,1.353147103,1.81461641,665,526,353,63,'01_28_03.c3d',3,VE,B,E,3,diff,139
771,901,130,1.063376356,1.569419557,554,598,211,1,'01_28_04.c3d',3,VE,B,E,4,diff,44
713,1495,782,1.24254895,1.457802223,583,523,1,1,'01_28_05.c3d',3,VE,B,E,5,diff,60
1023,1094,71,1.097578724,1.532153984,837,645,1,53,'01_28_01.c3d',4,VE,B,E,1,diff,192
949,1698,749,1.118841867,1.639145978,730,608,372,378,'01_28_02.c3d',4,VE,B,E,2,diff,122
988,1023,35,0.904381486,1.267659408,686,550,1,44,'01_28_03.c3d',4,VE,B,E,3,diff,136
908,957,49,0.837949197,1.503566707,665,505,193,113,'01_28_04.c3d',4,VE,B,E,4,diff,160
1072,1127,55,0.862640727,1.072630261,884,595,336,326,'01_28_05.c3d',4,VE,B,E,5,diff,289
835,897,62,1.389970115,1.799101793,630,589,334,287,'01_28_01.c3d',5,VE,B,E,1,diff,41
571,1462,891,2.188445434,3.170148341,457,438,262,262,'01_28_02.c3d',5,VE,B,E,2,diff,19
545,579,34,1.903706638,3.413533059,458,384,226,174,'01_28_03.c3d',5,VE,B,E,3,diff,74
694,879,185,1.691939074,3.064640431,539,514,312,303,'01_28_04.c3d',5,VE,B,E,4,diff,25
845,867,22,1.287323109,2.088147203,661,524,339,175,'01_28_05.c3d',5,VE,B,E,5,diff,137
1113,1956,843,1.073863302,1.842159687,907,1514,1,1,'01_28_01.c3d',6,VE,B,E,1,diff,607
944,1034,90,1.127491929,1.517483869,709,548,1,35,'01_28_02.c3d',6,VE,B,E,2,diff,161
924,937,13,1.047978174,1.951884088,724,562,1,1,'01_28_03.c3d',6,VE,B,E,3,diff,162
900,1691,791,1.259503159,1.916014485,735,661,1,318,'01_28_04.c3d',6,VE,B,E,4,diff,74
929,1127,198,1.229427202,1.505011014,746,577,1,76,'01_28_05.c3d',6,VE,B,E,5,diff,169
1818,2196,378,0.470692425,0.541527236,1140,1393,1,1,'01_28_01.c3d',7,VE,B,E,1,diff,253
1005,1170,165,0.838024176,1.172972879,659,510,1,164,'01_28_02.c3d',7,VE,B,E,2,diff,149
806,865,59,1.146703372,1.760611036,710,523,318,1,'01_28_03.c3d',7,VE,B,E,3,diff,187
841,881,40,1.05059241,1.523292258,649,481,1,1,'01_28_04.c3d',7,VE,B,E,4,diff,168
990,1060,70,0.902149757,1.543055753,770,599,342,1,'01_28_05.c3d',7,VE,B,E,5,diff,171
1301,1337,36,0.782691145,1.315314377,725,597,1,1,'01_28_01.c3d',8,VE,B,E,1,diff,128
1386,2137,751,0.829940705,1.533438407,815,656,1,420,'01_28_02.c3d',8,VE,B,E,2,diff,159
1649,1743,94,0.952363267,1.369750216,1212,1131,441,1,'01_28_03.c3d',8,VE,B,E,3,diff,81
1440,2248,808,0.842211831,0.95800968,944,653,1,452,'01_28_04.c3d',8,VE,B,E,4,diff,291
1158,1705,547,0.786217169,1.073315044,590,471,89,123,'01_28_05.c3d',8,VE,B,E,5,diff,119
1292,2776,1484,0.785647178,1.336829842,771,614,423,416,'01_28_01.c3d',9,VE,B,E,1,diff,157
948,1739,791,0.891229472,1.727855608,586,438,276,270,'01_28_02.c3d',9,VE,B,E,2,diff,148
1216,1722,506,1.139571203,1.791487072,681,495,317,319,'01_28_03.c3d',9,VE,B,E,3,diff,186
1402,1989,587,1.099780114,1.940599733,557,431,250,249,'01_28_04.c3d',9,VE,B,E,4,diff,126
1841,2645,804,0.781526214,1.189391847,1201,880,639,1,'01_28_05.c3d',9,VE,B,E,5,diff,321
863,879,16,1.375874818,1.816965997,717,733,237,247,'01_28_01.c3d',10,VE,B,E,1,diff,16
844,875,31,1.458258795,2.582492191,633,489,314,298,'01_28_02.c3d',10,VE,B,E,2,diff,144
778,844,66,1.16971572,1.655927064,496,321,70,84,'01_28_03.c3d',10,VE,B,E,3,diff,175
945,1105,160,1.225119831,2.044968958,692,556,1,309,'01_28_04.c3d',10,VE,B,E,4,diff,136
894,895,1,1.065356913,1.643682678,731,429,3,106,'01_28_05.c3d',10,VE,B,E,5,diff,302
1523,2135,612,0.608866562,0.622891707,1390,1084,402,1,'01_28_01.c3d',11,VE,B,E,1,diff,306
1679,1796,117,0.488802995,0.710448697,1232,1305,363,29,'01_28_02.c3d',11,VE,B,E,2,diff,73
1988,2760,772,0.462088713,0.491600393,1272,959,1,76,'01_28_03.c3d',11,VE,B,E,3,diff,313
1616,1677,61,0.781483471,0.917023879,884,637,1,281,'01_28_04.c3d',11,VE,B,E,4,diff,247
1199,1355,156,0.700115285,1.173822668,886,656,1,356,'01_28_05.c3d',11,VE,B,E,5,diff,230
965,1049,84,0.85650557,1.599516308,668,481,274,300,'01_28_01.c3d',12,VE,B,E,1,diff,187
1114,1134,20,0.963439687,1.670102424,693,681,480,455,'01_28_02.c3d',12,VE,B,E,2,diff,12
942,1149,207,1.010776869,1.291322369,779,569,346,1,'01_28_03.c3d',12,VE,B,E,3,diff,210
717,806,89,1.301746667,1.793068397,660,486,277,284,'01_28_04.c3d',12,VE,B,E,4,diff,174
880,963,83,1.011666178,1.408477508,648,499,99,116,'01_28_05.c3d',12,VE,B,E,5,diff,149
1273,1884,611,0.8624774,1.037149622,1028,1037,1,345,'01_28_01.c3d',13,VE,B,E,1,diff,9
898,1737,839,1.290828379,1.951986715,731,621,1,43,'01_28_02.c3d',13,VE,B,E,2,diff,110
1026,1090,64,1.028102096,1.700585138,811,555,323,115,'01_28_03.c3d',13,VE,B,E,3,diff,256
831,1443,612,1.308484269,2.101577257,687,484,1,203,'01_28_04.c3d',13,VE,B,E,4,diff,203
1160,1374,214,1.248488719,1.570896414,879,718,470,1,'01_28_05.c3d',13,VE,B,E,5,diff,161
690,713,23,1.55191541,3.082397846,626,468,1,266,'01_28_01.c3d',14,VE,B,E,1,diff,158
755,858,103,1.403708222,2.635041757,525,456,262,1,'01_28_02.c3d',14,VE,B,E,2,diff,69
721,882,161,1.265183708,2.603880959,467,407,212,2,'01_28_03.c3d',14,VE,B,E,3,diff,60
620,692,72,1.471700135,2.157307294,483,415,1,1,'01_28_04.c3d',14,VE,B,E,4,diff,68
740,803,63,1.300585288,2.31400231,480,437,1,228,'01_28_05.c3d',14,VE,B,E,5,diff,43
878,1117,239,1.124221469,1.988141264,684,606,330,363,'01_28_01.c3d',15,VE,B,E,1,diff,78
978,984,6,1.107137568,1.984486619,757,513,296,244,'01_28_02.c3d',15,VE,B,E,2,diff,244
822,881,59,1.264133822,1.278929026,690,487,182,1,'01_28_03.c3d',15,VE,B,E,3,diff,203
1021,1093,72,0.936593001,1.372273891,697,451,227,224,'01_28_04.c3d',15,VE,B,E,4,diff,246
754,2002,1248,1.175080325,1.257663456,575,483,50,33,'01_28_05.c3d',15,VE,B,E,5,diff,92
795,1256,461,1.321868026,1.737435967,633,464,257,261,'01_28_01.c3d',16,VE,B,E,1,diff,169
661,2570,1909,1.08543375,1.560149111,594,564,101,1,'01_28_02.c3d',16,VE,B,E,2,diff,30
873,1454,581,0.888319951,1.585978117,700,468,177,154,'01_28_03.c3d',16,VE,B,E,3,diff,232
1285,1551,266,0.9264323,1.124809411,918,620,1,408,'01_28_04.c3d',16,VE,B,E,4,diff,298
919,998,79,1.18845559,1.511081511,662,438,1,28,'01_28_05.c3d',16,VE,B,E,5,diff,224
711,719,8,1.625812886,2.591734779,546,444,254,239,'01_28_01.c3d',17,VE,B,E,1,diff,102
545,549,4,2.368478102,4.242578022,435,362,233,147,'01_28_02.c3d',17,VE,B,E,2,diff,73
624,740,116,2.134402273,2.420145887,545,474,288,283,'01_28_03.c3d',17,VE,B,E,3,diff,71
687,740,53,1.880694304,3.269493205,508,459,296,302,'01_28_04.c3d',17,VE,B,E,4,diff,49
615,728,113,1.650341122,2.825047663,430,420,263,270,'01_28_05.c3d',17,VE,B,E,5,diff,10
673,1554,881,1.223518752,1.770983788,486,507,1,1,'01_28_01.c3d',18,VE,B,E,1,diff,21
698,765,67,1.568508317,2.477289215,525,476,1,1,'01_28_02.c3d',18,VE,B,E,2,diff,49
810,874,64,1.211579856,2.638394891,687,505,1,313,'01_28_03.c3d',18,VE,B,E,3,diff,182
911,936,25,1.230790032,2.094005103,716,610,1,34,'01_28_04.c3d',18,VE,B,E,4,diff,106
846,1432,586,1.122667757,1.675076203,647,581,1,1,'01_28_05.c3d',18,VE,B,E,5,diff,66
982,1305,323,0.809092378,1.291199864,740,473,255,263,'01_28_01.c3d',19,VE,B,E,1,diff,267
1002,1092,90,0.86272559,1.425073601,829,551,319,1,'01_28_02.c3d',19,VE,B,E,2,diff,278
924,1479,555,1.162525669,1.725712689,704,639,315,368,'01_28_03.c3d',19,VE,B,E,3,diff,65
845,859,14,1.172562431,1.91140359,697,459,210,212,'01_28_04.c3d',19,VE,B,E,4,diff,238
876,887,11,1.11424007,1.681052415,652,455,223,255,'01_28_05.c3d',19,VE,B,E,5,diff,197
1198,1877,679,1.068082722,1.43169619,779,581,322,337,'01_28_01.c3d',20,VE,B,E,1,diff,198
985,1084,99,0.987673561,1.535577581,763,574,353,363,'01_28_02.c3d',20,VE,B,E,2,diff,189
1029,1232,203,0.91994119,1.578967922,697,458,262,269,'01_28_03.c3d',20,VE,B,E,3,diff,239
915,1021,106,1.047961323,1.707936727,596,469,262,1,'01_28_04.c3d',20,VE,B,E,4,diff,127
1618,1725,107,0.529484119,0.848841415,1028,466,275,1,'01_28_05.c3d',20,VE,B,E,5,diff,562
1136,1852,716,0.865575447,1.098839335,746,634,1,60,'01_28_01.c3d',21,VE,B,E,1,diff,112
1066,1142,76,0.970525343,1.379620623,752,540,310,293,'01_28_02.c3d',21,VE,B,E,2,diff,212
1336,1530,194,0.615170671,0.857097803,889,539,317,255,'01_28_03.c3d',21,VE,B,E,3,diff,350
1301,1363,62,0.777750656,1.112286628,718,520,283,271,'01_28_04.c3d',21,VE,B,E,4,diff,198
1084,2218,1134,0.857012264,0.89327378,919,600,298,1,'01_28_05.c3d',21,VE,B,E,5,diff,319
968,1059,91,1.031361279,1.763071307,828,572,301,319,'01_28_01.c3d',22,VE,B,E,1,diff,256
1062,1460,398,1.131397786,1.70181987,887,762,388,422,'01_28_02.c3d',22,VE,B,E,2,diff,125
1700,2063,363,0.77718386,1.222938208,879,746,361,380,'01_28_03.c3d',22,VE,B,E,3,diff,133
1382,1428,46,0.885179091,1.246141614,928,876,337,361,'01_28_04.c3d',22,VE,B,E,4,diff,52
1212,1218,6,0.772464927,1.234600492,732,752,276,309,'01_28_05.c3d',22,VE,B,E,5,diff,20
2205,2725,520,0.565231961,0.529930932,1105,806,378,25,'01_28_01.c3d',23,VE,B,E,1,diff,299
1621,2807,1186,0.519139965,0.787701801,1178,1632,260,284,'01_28_02.c3d',23,VE,B,E,2,diff,454
3608,5677,2069,0.455428551,0.587238345,1205,1225,390,13,'01_28_03.c3d',23,VE,B,E,3,diff,20
1870,3816,1946,0.439928255,0.748173045,1136,639,375,14,'01_28_04.c3d',23,VE,B,E,4,diff,497
2416,3700,1284,0.376794924,0.629402394,1622,3020,272,318,'01_28_05.c3d',23,VE,B,E,5,diff,1398
838,1601,763,1.277962362,1.594381055,598,502,249,246,'01_28_01.c3d',24,VE,B,E,1,diff,96
933,962,29,0.962219975,1.516141205,688,541,252,1,'01_28_02.c3d',24,VE,B,E,2,diff,147
850,1015,165,1.212355895,1.553770071,606,504,250,245,'01_28_03.c3d',24,VE,B,E,3,diff,102
860,927,67,1.022015049,1.492524372,679,454,227,158,'01_28_04.c3d',24,VE,B,E,4,diff,225
1027,1472,445,0.982099005,1.406568579,602,541,1,1,'01_28_05.c3d',24,VE,B,E,5,diff,61
769,1426,657,1.433782885,2.102987347,505,435,229,234,'01_28_01.c3d',25,VE,B,E,1,diff,70
1173,1473,300,0.97730908,1.258387687,722,579,334,358,'01_28_02.c3d',25,VE,B,E,2,diff,143
1149,1158,9,0.942525027,1.220063067,774,598,310,293,'01_28_03.c3d',25,VE,B,E,3,diff,176
956,975,19,1.06917211,1.331576731,619,494,246,261,'01_28_04.c3d',25,VE,B,E,4,diff,125
1017,1769,752,1.04983465,1.032268873,674,466,271,232,'01_28_05.c3d',25,VE,B,E,5,diff,208
1234,1366,132,0.660467333,1.289255457,978,699,349,362,'01_28_01.c3d',26,VE,B,E,1,diff,279
1539,2358,819,0.634488282,0.896615402,745,733,1,1,'01_28_02.c3d',26,VE,B,E,2,diff,12
1234,1427,193,0.64192181,0.842732618,925,543,1,1,'01_28_03.c3d',26,VE,B,E,3,diff,382
1833,3170,1337,0.566728595,1.506705693,1313,490,1,83,'01_28_04.c3d',26,VE,B,E,4,diff,823
1207,1303,96,0.626776862,1.055951212,879,1061,293,289,'01_28_05.c3d',26,VE,B,E,5,diff,182
1203,1316,113,1.072503059,1.691744097,923,807,472,400,'01_28_01.c3d',27,VE,B,E,1,diff,116
1261,1539,278,0.974984558,1.35258227,927,747,1,421,'01_28_02.c3d',27,VE,B,E,2,diff,180
2326,2449,123,0.585249713,0.787792455,926,893,1,11,'01_28_03.c3d',27,VE,B,E,3,diff,33
1141,1178,37,1.148306201,1.437386191,926,698,1,381,'01_28_04.c3d',27,VE,B,E,4,diff,228
1084,1546,462,0.984309262,1.599065253,879,673,415,385,'01_28_05.c3d',27,VE,B,E,5,diff,206
1639,2738,1099,0.766733558,1.171009174,2217,824,1,579,'01_28_01.c3d',28,VE,B,E,1,diff,1393
1306,1479,173,0.741424404,0.981305704,960,585,300,301,'01_28_02.c3d',28,VE,B,E,2,diff,375
1198,1205,7,0.938011211,1.024978198,918,661,1,310,'01_28_03.c3d',28,VE,B,E,3,diff,257
1779,1965,186,0.863868042,1.03132801,1489,1450,561,877,'01_28_04.c3d',28,VE,B,E,4,diff,39
1500,1527,27,0.790195976,0.914016742,1231,1221,596,505,'01_28_05.c3d',28,VE,B,E,5,diff,10
1186,1747,561,1.063174895,2.721921213,676,493,277,293,'01_28_01.c3d',29,VE,B,E,1,diff,183
924,940,16,0.908539747,1.539209683,681,459,1,238,'01_28_02.c3d',29,VE,B,E,2,diff,222
939,971,32,1.002874305,1.541761618,670,487,279,266,'01_28_03.c3d',29,VE,B,E,3,diff,183
883,957,74,1.026835758,1.773919148,649,480,259,275,'01_28_04.c3d',29,VE,B,E,4,diff,169
819,1450,631,1.166727318,1.535832577,669,501,1,200,'01_28_05.c3d',29,VE,B,E,5,diff,168
853,966,113,1.360144454,1.631585051,733,518,300,323,'01_28_01.c3d',30,VE,B,E,1,diff,215
1028,1105,77,0.959540591,1.604055742,723,526,299,305,'01_28_02.c3d',30,VE,B,E,2,diff,197
865,1419,554,0.875917626,1.140283301,600,365,1,127,'01_28_03.c3d',30,VE,B,E,3,diff,235
996,1937,941,0.931041562,0.986777852,780,445,1,252,'01_28_04.c3d',30,VE,B,E,4,diff,335
1137,1352,215,0.729778546,0.824138884,789,424,1,1,'01_28_05.c3d',30,VE,B,E,5,diff,365
1062,1134,72,1.372810216,2.041559026,743,629,394,403,'01_28_01.c3d',31,VE,B,E,1,diff,114
792,1016,224,1.919205927,2.774433643,684,510,309,301,'01_28_02.c3d',31,VE,B,E,2,diff,174
1084,1565,481,1.813063403,1.918532959,935,745,1,529,'01_28_03.c3d',31,VE,B,E,3,diff,190
884,1441,557,1.736075248,1.675398722,753,549,314,290,'01_28_04.c3d',31,VE,B,E,4,diff,204
824,903,79,1.773020747,1.842140432,659,540,287,287,'01_28_05.c3d',31,VE,B,E,5,diff,119
860,1123,263,1.061257687,1.439080242,823,560,372,355,'01_28_01.c3d',32,VE,B,E,1,diff,263
898,1001,103,1.057347206,1.614754674,717,503,317,298,'01_28_02.c3d',32,VE,B,E,2,diff,214
949,1067,118,1.118308797,1.45041777,742,518,324,299,'01_28_03.c3d',32,VE,B,E,3,diff,224
1199,1228,29,0.958922292,0.974172735,839,651,1,330,'01_28_04.c3d',32,VE,B,E,4,diff,188
1147,1571,424,1.144817766,1.629657101,914,691,459,1,'01_28_05.c3d',32,VE,B,E,5,diff,223
1302,1496,194,0.81469305,1.286476961,1083,729,1,1,'01_28_01.c3d',33,VE,B,E,1,diff,354
1318,1474,156,0.92962535,1.326316599,1174,864,625,1,'01_28_02.c3d',33,VE,B,E,2,diff,310
1271,1836,565,0.971998407,1.155965767,1079,723,440,426,'01_28_03.c3d',33,VE,B,E,3,diff,356
1209,1250,41,0.852389515,1.04969906,909,1126,384,1,'01_28_04.c3d',33,VE,B,E,4,diff,217
1022,1047,25,1.077091931,1.514706209,755,498,299,175,'01_28_05.c3d',33,VE,B,E,5,diff,257
862,1766,904,1.565235914,2.211671138,682,623,384,402,'01_28_01.c3d',34,VE,B,E,1,diff,59
951,954,3,1.143640685,2.040891834,659,520,339,117,'01_28_02.c3d',34,VE,B,E,2,diff,139
968,1000,32,1.095773387,1.789418076,704,537,335,317,'01_28_03.c3d',34,VE,B,E,3,diff,167
874,925,51,1.150729013,1.793941404,598,493,273,285,'01_28_04.c3d',34,VE,B,E,4,diff,105
841,1200,359,0.978726353,1.552545499,721,420,229,1,'01_28_05.c3d',34,VE,B,E,5,diff,301
902,1914,1012,1.08473806,1.921623326,626,482,289,282,'01_28_01.c3d',35,VE,B,E,1,diff,144
994,1570,576,0.959299778,1.874115535,718,533,1,17,'01_28_02.c3d',35,VE,B,E,2,diff,185
936,1448,512,1.359641545,2.021041665,567,462,219,1,'01_28_03.c3d',35,VE,B,E,3,diff,105
683,702,19,1.179882847,1.346613998,434,200,1,1,'01_28_04.c3d',35,VE,B,E,4,diff,234
748,883,135,1.285217114,1.878987337,587,453,230,230,'01_28_05.c3d',35,VE,B,E,5,diff,134
1330,1767,437,0.684838567,1.381587694,827,528,305,315,'01_29_01.c3d',1,VE,B,M,1,diff,299
827,1619,792,0.77933749,1.140656044,1490,744,197,24,'01_29_02.c3d',1,VE,B,M,2,diff,746
1068,1093,25,0.863891767,1.03401836,734,468,113,168,'01_29_03.c3d',1,VE,B,M,3,diff,266
1152,1215,63,0.836642646,1.165031091,834,600,1,1,'01_29_04.c3d',1,VE,B,M,4,diff,234
1104,2470,1366,0.90869075,0.921437245,887,526,178,1,'01_29_05.c3d',1,VE,B,M,5,diff,361
1332,1360,28,0.739904482,1.220920068,1051,711,1,367,'01_29_01.c3d',2,VE,B,M,1,diff,340
1196,2677,1481,0.773126702,0.833669716,847,1562,290,1,'01_29_02.c3d',2,VE,B,M,2,diff,715
1203,1340,137,0.746716243,1.230451884,846,487,248,9,'01_29_03.c3d',2,VE,B,M,3,diff,359
1488,2103,615,0.576415607,1.402336808,858,542,1,315,'01_29_04.c3d',2,VE,B,M,4,diff,316
1235,1340,105,0.715718091,1.077186819,910,1089,203,13,'01_29_05.c3d',2,VE,B,M,5,diff,179
801,855,54,1.340314261,2.299295458,771,541,1,321,'01_29_01.c3d',3,VE,B,M,1,diff,230
1017,1622,605,1.008712506,1.346137267,674,537,1,1,'01_29_02.c3d',3,VE,B,M,2,diff,137
638,917,279,1.237743653,1.847705223,619,476,240,214,'01_29_03.c3d',3,VE,B,M,3,diff,143
669,799,130,1.550062234,2.083047605,601,531,301,1,'01_29_04.c3d',3,VE,B,M,4,diff,70
851,1208,357,0.93320271,1.256726339,804,449,1,38,'01_29_05.c3d',3,VE,B,M,5,diff,355
959,1027,68,0.906348558,1.792203836,684,542,1,302,'01_29_01.c3d',4,VE,B,M,1,diff,142
958,1612,654,1.002316006,1.638821442,646,487,275,1,'01_29_02.c3d',4,VE,B,M,2,diff,159
1126,1422,296,0.791817278,1.054801508,802,540,325,322,'01_29_03.c3d',4,VE,B,M,3,diff,262
1096,1442,346,0.841436702,0.962009632,816,527,1,294,'01_29_04.c3d',4,VE,B,M,4,diff,289
1186,1259,73,0.633131187,0.876249794,905,729,1,1,'01_29_05.c3d',4,VE,B,M,5,diff,176
859,869,10,1.466092977,2.954682913,584,481,285,289,'01_29_01.c3d',5,VE,B,M,1,diff,103
941,968,27,1.444630867,2.94073867,808,601,374,415,'01_29_02.c3d',5,VE,B,M,2,diff,207
1111,1155,44,1.373878828,2.285041537,589,527,302,292,'01_29_03.c3d',5,VE,B,M,3,diff,62
756,984,228,1.50719636,2.785555493,525,445,1,257,'01_29_04.c3d',5,VE,B,M,4,diff,80
644,645,1,1.915788151,3.405595933,552,478,308,1,'01_29_05.c3d',5,VE,B,M,5,diff,74
1014,1222,208,1.17490075,1.270339493,891,756,438,36,'01_29_01.c3d',6,VE,B,M,1,diff,135
1381,1414,33,0.730835952,0.814903622,1167,849,1,1,'01_29_02.c3d',6,VE,B,M,2,diff,318
912,939,27,1.06408952,1.674237184,601,573,295,35,'01_29_03.c3d',6,VE,B,M,3,diff,28
872,1212,340,1.028562924,1.425429905,807,560,6,321,'01_29_04.c3d',6,VE,B,M,4,diff,247
1057,1075,18,0.930053306,1.357889772,737,626,66,32,'01_29_05.c3d',6,VE,B,M,5,diff,111
1460,2123,663,0.588939325,0.661798733,1032,653,1,105,'01_29_01.c3d',7,VE,B,M,1,diff,379
1199,1233,34,0.694062636,0.916150428,1054,512,306,43,'01_29_02.c3d',7,VE,B,M,2,diff,542
1031,1176,145,0.839435414,1.094182102,787,491,29,262,'01_29_03.c3d',7,VE,B,M,3,diff,296
882,1032,150,0.821992394,1.163912656,742,491,195,1,'01_29_04.c3d',7,VE,B,M,4,diff,251
1059,1256,197,0.694359918,1.309349998,720,576,301,49,'01_29_05.c3d',7,VE,B,M,5,diff,144
1697,1825,128,0.642526445,0.817024707,940,579,358,1,'01_29_01.c3d',8,VE,B,M,1,diff,361
1168,1422,254,0.823826086,1.049832244,795,537,310,325,'01_29_02.c3d',8,VE,B,M,2,diff,258
1745,1785,40,0.689940758,0.847017791,1252,882,644,36,'01_29_03.c3d',8,VE,B,M,3,diff,370
1530,1657,127,0.663669406,1.054005611,958,708,83,1,'01_29_04.c3d',8,VE,B,M,4,diff,250
1578,2262,684,0.55412858,0.784053972,881,544,1,1,'01_29_05.c3d',8,VE,B,M,5,diff,337
986,1801,815,0.48413692,1.603092973,944,477,282,280,'01_29_01.c3d',9,VE,B,M,1,diff,467
1216,1853,637,0.926109675,1.724598902,743,405,244,238,'01_29_02.c3d',9,VE,B,M,2,diff,338
1497,1699,202,0.742828977,1.017715985,778,440,296,167,'01_29_03.c3d',9,VE,B,M,3,diff,338
1042,1676,634,1.022804489,1.879716607,609,471,1,273,'01_29_04.c3d',9,VE,B,M,4,diff,138
1288,1847,559,0.856434118,1.204897273,691,496,290,285,'01_29_05.c3d',9,VE,B,M,5,diff,195
822,1306,484,1.406925722,2.852331796,599,466,211,272,'01_29_01.c3d',10,VE,B,M,1,diff,133
870,1310,440,1.006905441,1.46023303,657,427,24,1,'01_29_02.c3d',10,VE,B,M,2,diff,230
995,1006,11,0.883045224,1.38020895,492,328,46,73,'01_29_03.c3d',10,VE,B,M,3,diff,164
946,1034,88,0.937123513,1.503871507,671,422,137,107,'01_29_04.c3d',10,VE,B,M,4,diff,249
819,833,14,1.265700866,2.388430936,592,415,256,266,'01_29_05.c3d',10,VE,B,M,5,diff,177
953,1150,197,0.82448959,1.282031327,844,557,346,75,'01_29_01.c3d',11,VE,B,M,1,diff,287
1380,1690,310,0.615815046,0.814644658,1025,708,401,86,'01_29_02.c3d',11,VE,B,M,2,diff,317
1569,1639,70,0.559117385,0.811609988,1108,1162,358,47,'01_29_03.c3d',11,VE,B,M,3,diff,54
1433,1603,170,0.723141939,0.776395425,1257,1149,376,60,'01_29_04.c3d',11,VE,B,M,4,diff,108
1359,1418,59,0.641412013,0.712634977,1232,1083,348,1,'01_29_05.c3d',11,VE,B,M,5,diff,149
1086,1742,656,1.272964093,2.284140157,469,465,301,286,'01_29_01.c3d',12,VE,B,M,1,diff,4
712,848,136,1.193530417,1.821995751,627,471,266,254,'01_29_02.c3d',12,VE,B,M,2,diff,156
696,1152,456,1.078216456,1.709621906,607,473,1,276,'01_29_03.c3d',12,VE,B,M,3,diff,134
1153,1236,83,0.866038923,1.296383645,870,672,453,22,'01_29_04.c3d',12,VE,B,M,4,diff,198
1306,1332,26,0.715660758,1.072007819,888,745,404,460,'01_29_05.c3d',12,VE,B,M,5,diff,143
2014,2865,851,0.615277437,0.540710271,1504,1646,1,1,'01_29_01.c3d',13,VE,B,M,1,diff,142
1711,3175,1464,0.734228258,0.851933565,1313,1223,647,1,'01_29_02.c3d',13,VE,B,M,2,diff,90
1070,1173,103,1.055817524,1.416907026,823,629,293,355,'01_29_03.c3d',13,VE,B,M,3,diff,194
1006,2396,1390,1.103380322,1.802197718,712,605,350,1,'01_29_04.c3d',13,VE,B,M,4,diff,107
1103,1842,739,0.897813546,1.757411425,828,573,328,1,'01_29_05.c3d',13,VE,B,M,5,diff,255
707,843,136,1.483664155,2.991598037,602,431,222,1,'01_29_01.c3d',14,VE,B,M,1,diff,171
824,898,74,1.280301085,2.57018349,555,460,1,263,'01_29_02.c3d',14,VE,B,M,2,diff,95
782,1275,493,1.123843033,2.18622321,623,424,231,92,'01_29_03.c3d',14,VE,B,M,3,diff,199
999,1754,755,1.02306135,2.201843428,804,615,260,252,'01_29_04.c3d',14,VE,B,M,4,diff,189
880,904,24,1.203459263,1.691679932,552,504,1,72,'01_29_05.c3d',14,VE,B,M,5,diff,48
1003,1327,324,1.140653332,1.953004301,761,545,281,276,'01_29_01.c3d',15,VE,B,M,1,diff,216
1077,1147,70,0.954096061,2.05871648,711,489,270,291,'01_29_02.c3d',15,VE,B,M,2,diff,222
939,1000,61,1.146550723,2.055576798,756,558,323,16,'01_29_03.c3d',15,VE,B,M,3,diff,198
898,922,24,0.967978958,1.390157978,656,455,1,99,'01_29_04.c3d',15,VE,B,M,4,diff,201
981,1182,201,0.94531319,1.211604446,738,533,146,99,'01_29_05.c3d',15,VE,B,M,5,diff,205
806,920,114,1.194440957,1.733288949,714,426,1,219,'01_29_01.c3d',16,VE,B,M,1,diff,288
1274,1444,170,0.752961539,1.556061918,855,472,1,293,'01_29_02.c3d',16,VE,B,M,2,diff,383
939,1334,395,0.985358178,1.725359101,666,492,1,64,'01_29_03.c3d',16,VE,B,M,3,diff,174
1034,1049,15,0.989309113,1.326688432,823,515,316,1,'01_29_04.c3d',16,VE,B,M,4,diff,308
717,1029,312,0.943646638,1.61739601,612,372,157,72,'01_29_05.c3d',16,VE,B,M,5,diff,240
612,615,3,2.26032846,3.332677267,533,407,251,261,'01_29_01.c3d',17,VE,B,M,1,diff,126
632,854,222,1.702242373,2.389266804,514,455,265,274,'01_29_02.c3d',17,VE,B,M,2,diff,59
686,700,14,1.920767,2.82884719,548,433,278,278,'01_29_03.c3d',17,VE,B,M,3,diff,115
563,772,209,2.20654606,3.117987686,507,414,244,246,'01_29_04.c3d',17,VE,B,M,4,diff,93
629,778,149,1.64718444,3.51491711,496,361,1,245,'01_29_05.c3d',17,VE,B,M,5,diff,135
976,1000,24,1.217649929,1.887807227,733,560,1,252,'01_29_01.c3d',18,VE,B,M,1,diff,173
770,865,95,1.170061668,2.093005918,591,448,241,1,'01_29_02.c3d',18,VE,B,M,2,diff,143
674,767,93,1.274122206,1.96755719,577,436,1,1,'01_29_03.c3d',18,VE,B,M,3,diff,141
717,746,29,0.914727712,2.104532993,484,477,1,1,'01_29_04.c3d',18,VE,B,M,4,diff,7
969,990,21,0.959271656,1.798199118,696,532,1,1,'01_29_05.c3d',18,VE,B,M,5,diff,164
1224,1536,312,0.658105056,1.33439234,863,490,278,295,'01_29_01.c3d',19,VE,B,M,1,diff,373
884,1020,136,0.922217829,1.51062944,689,486,241,259,'01_29_02.c3d',19,VE,B,M,2,diff,203
989,1429,440,1.097682484,1.766213724,797,539,359,1,'01_29_03.c3d',19,VE,B,M,3,diff,258
1243,1354,111,0.797949795,1.068478191,841,761,104,254,'01_29_04.c3d',19,VE,B,M,4,diff,80
881,1076,195,1.006135568,1.384422249,627,439,1,27,'01_29_05.c3d',19,VE,B,M,5,diff,188
1005,1136,131,0.936352767,1.8301528,835,595,385,385,'01_29_01.c3d',20,VE,B,M,1,diff,240
858,964,106,1.009568216,1.851291877,713,474,277,273,'01_29_02.c3d',20,VE,B,M,2,diff,239
845,1158,313,0.896440984,1.792627189,772,432,258,249,'01_29_03.c3d',20,VE,B,M,3,diff,340
900,1029,129,0.995410944,1.54380856,825,551,306,1,'01_29_04.c3d',20,VE,B,M,4,diff,274
1038,1162,124,1.094414902,1.612765977,696,440,1,61,'01_29_05.c3d',20,VE,B,M,5,diff,256
1108,1150,42,0.973335009,1.437224158,945,620,1,10,'01_29_01.c3d',21,VE,B,M,1,diff,325
970,1349,379,0.771027022,1.321062643,646,496,281,296,'01_29_02.c3d',21,VE,B,M,2,diff,150
1197,1341,144,0.802688443,1.174692298,791,578,19,347,'01_29_03.c3d',21,VE,B,M,3,diff,213
1335,1743,408,0.647439614,0.91316214,760,542,1,1,'01_29_04.c3d',21,VE,B,M,4,diff,218
1556,2451,895,0.655554281,1.006752454,786,590,361,1,'01_29_05.c3d',21,VE,B,M,5,diff,196
1300,1835,535,0.900143209,0.976180412,1101,691,411,1,'01_29_01.c3d',22,VE,B,M,1,diff,410
1005,1203,198,0.898842632,1.575364096,850,612,341,24,'01_29_02.c3d',22,VE,B,M,2,diff,238
1128,1176,48,0.85416094,1.569949744,887,635,327,385,'01_29_03.c3d',22,VE,B,M,3,diff,252
1189,1194,5,0.882794924,1.251130569,961,879,329,51,'01_29_04.c3d',22,VE,B,M,4,diff,82
1575,1717,142,0.692000448,0.892104637,999,880,383,1,'01_29_05.c3d',22,VE,B,M,5,diff,119
1792,2684,892,0.640690734,0.750733043,982,652,1,52,'01_29_01.c3d',23,VE,B,M,1,diff,330
1783,4394,2611,0.42705636,1.170964955,1467,631,1,45,'01_29_02.c3d',23,VE,B,M,2,diff,836
1810,5313,3503,0.505549345,0.522253475,1230,2681,294,29,'01_29_03.c3d',23,VE,B,M,3,diff,1451
2198,4067,1869,0.441558068,0.505535071,998,2763,1,144,'01_29_04.c3d',23,VE,B,M,4,diff,1765
2267,2571,304,0.396490845,0.55861201,1379,594,1,366,'01_29_05.c3d',23,VE,B,M,5,diff,785
946,1036,90,1.128166548,1.903205396,685,506,297,286,'01_29_01.c3d',24,VE,B,M,1,diff,179
931,1294,363,0.79511271,1.864445327,666,469,231,256,'01_29_02.c3d',24,VE,B,M,2,diff,197
986,1070,84,1.061187894,1.316809931,818,568,261,1,'01_29_03.c3d',24,VE,B,M,3,diff,250
911,979,68,1.034528538,1.445495983,695,473,184,1,'01_29_04.c3d',24,VE,B,M,4,diff,222
1021,1168,147,0.987509001,1.294705909,663,448,245,35,'01_29_05.c3d',24,VE,B,M,5,diff,215
1129,1171,42,0.888882212,1.252871636,669,468,243,258,'01_29_01.c3d',25,VE,B,M,1,diff,201
1031,1575,544,0.836547267,0.996698446,847,486,266,253,'01_29_02.c3d',25,VE,B,M,2,diff,361
1164,1246,82,0.804954895,1.40641155,732,499,294,292,'01_29_03.c3d',25,VE,B,M,3,diff,233
1148,1569,421,0.93228751,1.158438851,694,460,247,242,'01_29_04.c3d',25,VE,B,M,4,diff,234
1129,1671,542,0.991880315,1.499956185,696,485,280,275,'01_29_05.c3d',25,VE,B,M,5,diff,211
1376,3796,2420,0.667861454,0.967773134,1177,473,1,1,'01_29_01.c3d',26,VE,B,M,1,diff,704
1792,2227,435,0.485937563,0.958916515,1348,633,1,1,'01_29_02.c3d',26,VE,B,M,2,diff,715
1403,1740,337,0.540198916,0.945268169,1001,1503,62,1,'01_29_03.c3d',26,VE,B,M,3,diff,502
1132,1171,39,0.805411513,1.226632917,1043,558,380,312,'01_29_04.c3d',26,VE,B,M,4,diff,485
1773,2994,1221,0.405560463,0.656546897,1250,511,1,36,'01_29_05.c3d',26,VE,B,M,5,diff,739
1311,1487,176,0.860620454,1.27966903,770,558,363,44,'01_29_01.c3d',27,VE,B,M,1,diff,212
1169,1421,252,0.819774815,1.214877891,971,641,339,318,'01_29_02.c3d',27,VE,B,M,2,diff,330
1730,2119,389,0.7758968,0.927951386,1085,1117,1,425,'01_29_03.c3d',27,VE,B,M,3,diff,32
1498,1743,245,0.913943574,1.018114796,1170,911,656,609,'01_29_04.c3d',27,VE,B,M,4,diff,259
1180,1720,540,1.11210885,1.468249468,1086,1047,555,513,'01_29_05.c3d',27,VE,B,M,5,diff,39
1907,3009,1102,0.670640313,0.778731681,2906,1412,759,21,'01_29_01.c3d',28,VE,B,M,1,diff,1494
1353,1591,238,0.842707329,0.92970391,1129,554,351,1,'01_29_02.c3d',28,VE,B,M,2,diff,575
1516,1575,59,0.718495198,0.872247707,1149,915,274,275,'01_29_03.c3d',28,VE,B,M,3,diff,234
1284,1480,196,0.891239806,0.776817709,1067,936,281,258,'01_29_04.c3d',28,VE,B,M,4,diff,131
1553,2052,499,0.604672497,0.907410179,1277,970,1,26,'01_29_05.c3d',28,VE,B,M,5,diff,307
784,2400,1616,1.566714569,2.61402726,637,509,282,307,'01_29_01.c3d',29,VE,B,M,1,diff,128
830,993,163,1.280487039,2.149141171,601,457,247,168,'01_29_02.c3d',29,VE,B,M,2,diff,144
1007,1133,126,0.963645176,1.608530019,681,520,1,313,'01_29_03.c3d',29,VE,B,M,3,diff,161
1215,1508,293,0.809516733,1.279474083,819,561,12,344,'01_29_04.c3d',29,VE,B,M,4,diff,258
1581,1712,131,0.638251971,1.046804088,817,497,1,248,'01_29_05.c3d',29,VE,B,M,5,diff,320
1331,1475,144,1.132746059,1.302566384,1107,953,678,17,'01_29_01.c3d',30,VE,B,M,1,diff,154
935,944,9,0.915559441,1.206881202,750,438,125,209,'01_29_02.c3d',30,VE,B,M,2,diff,312
1164,1283,119,0.840466474,0.762818812,829,460,211,233,'01_29_03.c3d',30,VE,B,M,3,diff,369
1184,1675,491,0.761776356,0.987760173,809,518,273,1,'01_29_04.c3d',30,VE,B,M,4,diff,291
1081,1341,260,0.754866511,0.722200901,834,435,101,1,'01_29_05.c3d',30,VE,B,M,5,diff,399
931,1359,428,1.5343459,2.146897125,696,526,1,309,'01_29_01.c3d',31,VE,B,M,1,diff,170
911,954,43,1.484769997,1.97989358,728,483,296,281,'01_29_02.c3d',31,VE,B,M,2,diff,245
894,930,36,1.495601755,1.998840361,677,493,299,294,'01_29_03.c3d',31,VE,B,M,3,diff,184
1036,1564,528,1.292289846,1.824666555,794,496,270,273,'01_29_04.c3d',31,VE,B,M,4,diff,298
1016,1381,365,1.481765486,1.980392462,767,567,1,387,'01_29_05.c3d',31,VE,B,M,5,diff,200
987,1004,17,1.183509107,1.763483759,733,575,23,359,'01_29_01.c3d',32,VE,B,M,1,diff,158
1202,2554,1352,1.158842949,1.844579159,679,509,1,134,'01_29_02.c3d',32,VE,B,M,2,diff,170
1072,1987,915,1.030906036,1.676060534,761,537,299,289,'01_29_03.c3d',32,VE,B,M,3,diff,224
1176,1248,72,0.858088883,0.917781161,915,912,327,105,'01_29_04.c3d',32,VE,B,M,4,diff,3
1336,1468,132,0.759429296,1.168445074,911,798,365,1,'01_29_05.c3d',32,VE,B,M,5,diff,113
1138,1368,230,0.905469241,1.533243119,973,586,364,338,'01_29_01.c3d',33,VE,B,M,1,diff,387
1145,1292,147,0.812354408,1.156067224,947,586,375,345,'01_29_02.c3d',33,VE,B,M,2,diff,361
1191,1386,195,0.976734557,1.252836725,907,594,328,1,'01_29_03.c3d',33,VE,B,M,3,diff,313
982,1153,171,0.965988312,1.373485843,874,525,330,289,'01_29_04.c3d',33,VE,B,M,4,diff,349
1095,1148,53,1.03908524,1.359769074,822,554,326,307,'01_29_05.c3d',33,VE,B,M,5,diff,268
902,1224,322,1.206709557,1.860522417,841,691,486,486,'01_29_01.c3d',34,VE,B,M,1,diff,150
956,1006,50,1.230603949,1.456678184,708,524,344,336,'01_29_02.c3d',34,VE,B,M,2,diff,184
655,808,153,1.238729856,2.305061045,631,443,285,259,'01_29_03.c3d',34,VE,B,M,3,diff,188
1127,1302,175,0.920105099,2.045950203,743,536,1,350,'01_29_04.c3d',34,VE,B,M,4,diff,207
992,1000,8,1.040697986,1.894849833,689,545,308,324,'01_29_05.c3d',34,VE,B,M,5,diff,144
1568,1597,29,0.709431729,0.999567391,1140,1109,1,1,'01_29_01.c3d',35,VE,B,M,1,diff,31
1810,2275,465,0.839225078,1.538346192,633,552,1,300,'01_29_02.c3d',35,VE,B,M,2,diff,81
969,1504,535,1.218378735,1.487687302,754,471,242,243,'01_29_03.c3d',35,VE,B,M,3,diff,283
959,1015,56,1.164706054,2.211447658,508,408,86,64,'01_29_04.c3d',35,VE,B,M,4,diff,100
978,1486,508,1.122485633,0.941722551,769,406,170,113,'01_29_05.c3d',35,VE,B,M,5,diff,363
1192,2090,898,0.709489502,0.753603311,996,431,214,1,'01_30_01.c3d',1,VE,B,H,1,diff,565
1161,1255,94,0.897953884,1.182753011,817,526,1,244,'01_30_02.c3d',1,VE,B,H,2,diff,291
1021,1454,433,0.853517549,0.959104279,767,397,1,1,'01_30_03.c3d',1,VE,B,H,3,diff,370
1250,1279,29,0.789611058,1.145309851,813,447,245,31,'01_30_04.c3d',1,VE,B,H,4,diff,366
987,992,5,0.916104712,0.996460009,814,379,135,46,'01_30_05.c3d',1,VE,B,H,5,diff,435
1719,2188,469,0.733248668,1.30303449,1386,1062,583,1,'01_30_01.c3d',2,VE,B,H,1,diff,324
1117,1406,289,0.639888058,1.40462241,947,550,1,340,'01_30_02.c3d',2,VE,B,H,2,diff,397
1316,1427,111,0.598590086,1.072359046,1153,415,257,1,'01_30_03.c3d',2,VE,B,H,3,diff,738
1575,3083,1508,0.605737983,1.041856646,982,585,1,1,'01_30_04.c3d',2,VE,B,H,4,diff,397
1538,1552,14,0.503397069,0.95335895,936,495,295,33,'01_30_05.c3d',2,VE,B,H,5,diff,441
843,981,138,1.01976788,1.815307898,756,544,1,1,'01_30_01.c3d',3,VE,B,H,1,diff,212
918,926,8,1.170474015,1.68473741,665,473,1,1,'01_30_02.c3d',3,VE,B,H,2,diff,192
798,871,73,1.19829919,2.006564933,622,445,259,276,'01_30_03.c3d',3,VE,B,H,3,diff,177
966,1110,144,0.7680102,1.517768644,840,459,270,70,'01_30_04.c3d',3,VE,B,H,4,diff,381
958,1082,124,1.115638699,1.321348271,641,612,1,1,'01_30_05.c3d',3,VE,B,H,5,diff,29
887,1141,254,0.900630496,1.151097265,768,525,313,1,'01_30_01.c3d',4,VE,B,H,1,diff,243
1099,1388,289,0.691761916,1.011178864,831,498,1,266,'01_30_02.c3d',4,VE,B,H,2,diff,333
1101,1135,34,0.811280381,1.231237877,715,481,262,264,'01_30_03.c3d',4,VE,B,H,3,diff,234
1067,1096,29,0.700814684,1.238092282,681,480,229,3,'01_30_04.c3d',4,VE,B,H,4,diff,201
1214,1236,22,0.731841185,1.030800129,898,736,288,55,'01_30_05.c3d',4,VE,B,H,5,diff,162
729,1596,867,1.504858605,2.215973202,554,456,1,65,'01_30_01.c3d',5,VE,B,H,1,diff,98
619,809,190,1.541733841,3.966205971,414,436,1,284,'01_30_02.c3d',5,VE,B,H,2,diff,22
686,841,155,1.183563829,1.564514633,596,335,79,116,'01_30_03.c3d',5,VE,B,H,3,diff,261
910,986,76,1.098653863,2.473412319,636,497,344,326,'01_30_04.c3d',5,VE,B,H,4,diff,139
763,860,97,1.295101501,2.486332064,583,432,273,1,'01_30_05.c3d',5,VE,B,H,5,diff,151
1013,1130,117,0.824435913,1.592453096,785,565,35,1,'01_30_01.c3d',6,VE,B,H,1,diff,220
1209,1236,27,1.021353544,1.243480451,785,565,321,1,'01_30_02.c3d',6,VE,B,H,2,diff,220
1010,1487,477,0.845907233,1.639484666,941,563,14,48,'01_30_03.c3d',6,VE,B,H,3,diff,378
1045,1071,26,1.045377257,1.326135601,806,620,351,47,'01_30_04.c3d',6,VE,B,H,4,diff,186
1245,1326,81,0.938254743,1.219724787,901,674,458,372,'01_30_05.c3d',6,VE,B,H,5,diff,227
1651,2049,398,0.558884882,1.103570722,895,646,1,42,'01_30_01.c3d',7,VE,B,H,1,diff,249
999,1080,81,0.756835404,0.980615707,734,410,201,55,'01_30_02.c3d',7,VE,B,H,2,diff,324
983,1508,525,0.888298911,1.134297876,701,448,251,1,'01_30_03.c3d',7,VE,B,H,3,diff,253
910,974,64,0.884746253,1.254095041,695,452,118,23,'01_30_04.c3d',7,VE,B,H,4,diff,243
865,1120,255,0.907067299,0.830130934,595,366,126,1,'01_30_05.c3d',7,VE,B,H,5,diff,229
1484,1719,235,0.640655698,0.986706178,791,566,1,351,'01_30_01.c3d',8,VE,B,H,1,diff,225
1378,1387,9,0.650935028,1.2563558,825,488,1,46,'01_30_02.c3d',8,VE,B,H,2,diff,337
2004,2479,475,0.447985662,0.591944425,1327,576,1,370,'01_30_03.c3d',8,VE,B,H,3,diff,751
1604,1686,82,0.473469829,0.896027585,1293,604,288,22,'01_30_04.c3d',8,VE,B,H,4,diff,689
1505,1533,28,0.587995022,1.023690343,827,455,236,243,'01_30_05.c3d',8,VE,B,H,5,diff,372
1149,2196,1047,0.529657858,1.892759799,852,557,1,1,'01_30_01.c3d',9,VE,B,H,1,diff,295
1195,1214,19,0.931153866,1.527941571,802,564,397,413,'01_30_02.c3d',9,VE,B,H,2,diff,238
1215,2067,852,0.972455957,1.702129163,834,661,473,1,'01_30_03.c3d',9,VE,B,H,3,diff,173
909,1834,925,0.924205602,1.75849564,608,439,102,99,'01_30_04.c3d',9,VE,B,H,4,diff,169
1098,1798,700,0.742528038,1.239318495,794,547,336,1,'01_30_05.c3d',9,VE,B,H,5,diff,247
770,924,154,1.45741511,2.517677549,720,528,323,336,'01_30_01.c3d',10,VE,B,H,1,diff,192
1081,1285,204,0.878872959,1.794000536,720,486,261,276,'01_30_02.c3d',10,VE,B,H,2,diff,234
850,1035,185,1.104474765,1.886794218,650,416,1,1,'01_30_03.c3d',10,VE,B,H,3,diff,234
1417,2013,596,0.647633091,1.220203071,952,519,1,306,'01_30_04.c3d',10,VE,B,H,4,diff,433
740,883,143,0.92375752,1.225078286,434,167,1,1,'01_30_05.c3d',10,VE,B,H,5,diff,267
2127,4308,2181,0.377549302,0.493318672,1589,1704,1,1,'01_30_01.c3d',11,VE,B,H,1,diff,115
1070,1627,557,0.945365354,1.095317349,807,511,302,291,'01_30_02.c3d',11,VE,B,H,2,diff,296
1448,1450,2,0.666544381,0.912156699,993,607,1,5,'01_30_03.c3d',11,VE,B,H,3,diff,386
1340,1552,212,0.639698279,0.855957891,940,548,271,75,'01_30_04.c3d',11,VE,B,H,4,diff,392
1531,2443,912,0.525834459,0.628545333,1036,567,329,312,'01_30_05.c3d',11,VE,B,H,5,diff,469
979,1030,51,0.990493933,1.39025136,656,508,291,61,'01_30_01.c3d',12,VE,B,H,1,diff,148
964,977,13,0.917373033,1.77583148,632,559,309,296,'01_30_02.c3d',12,VE,B,H,2,diff,73
985,1303,318,0.745638135,1.501959548,700,480,269,288,'01_30_03.c3d',12,VE,B,H,3,diff,220
954,1061,107,0.970234742,1.278355164,668,459,264,63,'01_30_04.c3d',12,VE,B,H,4,diff,209
1029,1125,96,0.914690712,1.55772559,646,450,283,278,'01_30_05.c3d',12,VE,B,H,5,diff,196
1057,4371,3314,1.070258351,1.444914579,831,561,10,1,'01_30_01.c3d',13,VE,B,H,1,diff,270
1178,1389,211,0.909901159,1.312227576,905,778,1,93,'01_30_02.c3d',13,VE,B,H,2,diff,127
805,896,91,1.144282644,1.802650459,583,494,270,1,'01_30_03.c3d',13,VE,B,H,3,diff,89
954,1065,111,1.062122109,1.739384283,715,496,263,20,'01_30_04.c3d',13,VE,B,H,4,diff,219
1162,1411,249,1.026876413,1.344418197,816,515,1,1,'01_30_05.c3d',13,VE,B,H,5,diff,301
934,1775,841,0.960417359,1.625701095,754,491,1,1,'01_30_01.c3d',14,VE,B,H,1,diff,263
685,845,160,1.31083243,3.125919316,656,435,221,235,'01_30_02.c3d',14,VE,B,H,2,diff,221
753,773,20,1.363466831,2.228272164,622,476,255,241,'01_30_03.c3d',14,VE,B,H,3,diff,146
828,879,51,1.292544877,2.925371401,649,504,286,29,'01_30_04.c3d',14,VE,B,H,4,diff,145
861,908,47,1.245012251,2.145040894,633,514,305,333,'01_30_05.c3d',14,VE,B,H,5,diff,119
1096,1109,13,0.899202837,1.429605416,754,512,1,305,'01_30_01.c3d',15,VE,B,H,1,diff,242
948,1041,93,1.099163802,1.840902078,725,486,253,222,'01_30_02.c3d',15,VE,B,H,2,diff,239
1019,1051,32,0.963117113,1.64359149,693,478,221,235,'01_30_03.c3d',15,VE,B,H,3,diff,215
1145,1466,321,0.859710881,1.392438492,850,503,313,295,'01_30_04.c3d',15,VE,B,H,4,diff,347
1295,1465,170,0.720678192,1.075983763,858,482,282,1,'01_30_05.c3d',15,VE,B,H,5,diff,376
1010,1143,133,1.127944886,2.848720923,800,470,281,295,'01_30_01.c3d',16,VE,B,H,1,diff,330
703,1268,565,1.07239888,1.97125037,660,396,237,48,'01_30_02.c3d',16,VE,B,H,2,diff,264
780,1706,926,1.085782031,1.824990524,660,450,266,65,'01_30_03.c3d',16,VE,B,H,3,diff,210
957,1422,465,0.741263642,1.676425755,1003,635,1,39,'01_30_04.c3d',16,VE,B,H,4,diff,368
1384,1394,10,0.690063341,1.38357398,954,513,296,330,'01_30_05.c3d',16,VE,B,H,5,diff,441
701,957,256,1.505648404,3.168150563,523,373,239,246,'01_30_01.c3d',17,VE,B,H,1,diff,150
615,642,27,1.714579593,3.458355921,453,385,250,258,'01_30_02.c3d',17,VE,B,H,2,diff,68
761,863,102,1.621524344,3.019754567,616,477,311,331,'01_30_03.c3d',17,VE,B,H,3,diff,139
762,765,3,1.412332855,3.587422277,523,422,285,298,'01_30_04.c3d',17,VE,B,H,4,diff,101
728,894,166,1.444647435,1.867745005,526,392,255,252,'01_30_05.c3d',17,VE,B,H,5,diff,134
1050,1377,327,0.648213465,1.661942367,686,508,285,29,'01_30_01.c3d',18,VE,B,H,1,diff,178
820,1995,1175,1.271305957,2.771271079,569,481,219,259,'01_30_02.c3d',18,VE,B,H,2,diff,88
562,1117,555,1.219165924,1.364424339,422,502,1,1,'01_30_03.c3d',18,VE,B,H,3,diff,80
818,1009,191,0.978123346,1.772772451,745,495,323,1,'01_30_04.c3d',18,VE,B,H,4,diff,250
921,1574,653,1.266659662,2.217223364,1,626,1,1,'01_30_05.c3d',18,VE,B,H,5,diff,625
1223,1265,42,0.751030251,1.359762479,712,463,1,69,'01_30_01.c3d',19,VE,B,H,1,diff,249
1101,1221,120,0.87020682,1.2909332,850,453,288,257,'01_30_02.c3d',19,VE,B,H,2,diff,397
1134,1135,1,0.945348218,1.247879836,785,632,372,200,'01_30_03.c3d',19,VE,B,H,3,diff,153
983,1080,97,0.914467663,1.38598043,773,554,1,87,'01_30_04.c3d',19,VE,B,H,4,diff,219
1241,1283,42,0.824124179,1.25248834,818,536,277,1,'01_30_05.c3d',19,VE,B,H,5,diff,282
1036,1112,76,0.903154212,1.636651646,764,521,1,308,'01_30_01.c3d',20,VE,B,H,1,diff,243
978,1103,125,0.925456732,1.471219699,761,484,316,302,'01_30_02.c3d',20,VE,B,H,2,diff,277
985,1043,58,1.002220534,1.83491758,750,509,362,325,'01_30_03.c3d',20,VE,B,H,3,diff,241
1032,1131,99,0.845217365,1.365745685,875,471,294,292,'01_30_04.c3d',20,VE,B,H,4,diff,404
943,1131,188,0.833695356,1.447399486,811,452,272,255,'01_30_05.c3d',20,VE,B,H,5,diff,359
1177,1522,345,0.713920917,1.151328445,921,544,1,1,'01_30_01.c3d',21,VE,B,H,1,diff,377
1132,1664,532,0.811014617,0.994656956,833,600,326,342,'01_30_02.c3d',21,VE,B,H,2,diff,233
1388,1459,71,0.669877717,1.174220995,864,585,381,53,'01_30_03.c3d',21,VE,B,H,3,diff,279
1374,1460,86,0.732552779,0.745464744,921,821,362,1,'01_30_04.c3d',21,VE,B,H,4,diff,100
1570,1613,43,0.667976269,1.061817718,855,693,492,509,'01_30_05.c3d',21,VE,B,H,5,diff,162
1205,1426,221,0.836569578,1.431066687,818,564,288,289,'01_30_01.c3d',22,VE,B,H,1,diff,254
1279,1295,16,0.813400803,1.282844624,1014,792,364,404,'01_30_02.c3d',22,VE,B,H,2,diff,222
1244,1386,142,0.831940975,1.075927753,945,921,350,361,'01_30_03.c3d',22,VE,B,H,3,diff,24
1217,1318,101,0.892923077,1.297600935,929,766,317,355,'01_30_04.c3d',22,VE,B,H,4,diff,163
1813,1896,83,0.761738373,1.009777606,1061,936,371,415,'01_30_05.c3d',22,VE,B,H,5,diff,125
1966,2761,795,0.500498657,0.657133282,864,1729,1,27,'01_30_01.c3d',23,VE,B,H,1,diff,865
2014,5935,3921,0.463004497,0.717147398,1664,1743,500,37,'01_30_02.c3d',23,VE,B,H,2,diff,79
2024,3735,1711,0.434491827,0.594784245,1353,1156,300,36,'01_30_03.c3d',23,VE,B,H,3,diff,197
2161,5079,2918,0.372258162,0.443467003,1464,2929,306,339,'01_30_04.c3d',23,VE,B,H,4,diff,1465
2283,6255,3972,0.356114684,0.553034156,1260,1407,311,420,'01_30_05.c3d',23,VE,B,H,5,diff,147
1021,1106,85,0.872234236,1.410510087,742,407,216,202,'01_30_01.c3d',24,VE,B,H,1,diff,335
1013,1101,88,0.950111969,1.632599137,780,526,304,1,'01_30_02.c3d',24,VE,B,H,2,diff,254
1124,1622,498,0.903549312,1.170031894,844,430,234,64,'01_30_03.c3d',24,VE,B,H,3,diff,414
973,1386,413,0.975613036,1.310314522,700,458,229,241,'01_30_04.c3d',24,VE,B,H,4,diff,242
1176,1219,43,0.727997958,1.300522932,627,468,1,127,'01_30_05.c3d',24,VE,B,H,5,diff,159
1234,1629,395,0.772879069,1.358269695,795,511,274,285,'01_30_01.c3d',25,VE,B,H,1,diff,284
1053,1293,240,0.993098229,1.490851904,658,479,260,255,'01_30_02.c3d',25,VE,B,H,2,diff,179
1297,1539,242,0.715673568,1.080195632,769,372,1,103,'01_30_03.c3d',25,VE,B,H,3,diff,397
1429,2046,617,0.686573867,0.836350672,892,455,245,256,'01_30_04.c3d',25,VE,B,H,4,diff,437
1001,1018,17,0.956192613,1.39638434,726,466,238,65,'01_30_05.c3d',25,VE,B,H,5,diff,260
1531,3278,1747,0.513945832,0.890796091,1063,581,383,15,'01_30_01.c3d',26,VE,B,H,1,diff,482
1131,2108,977,0.736398914,1.089367527,868,509,301,1,'01_30_02.c3d',26,VE,B,H,2,diff,359
1213,1220,7,0.658402916,0.971760069,1088,501,317,1,'01_30_03.c3d',26,VE,B,H,3,diff,587
1189,1240,51,0.679994869,0.935173278,974,576,71,385,'01_30_04.c3d',26,VE,B,H,4,diff,398
1304,1671,367,0.667681241,0.968399976,873,590,329,54,'01_30_05.c3d',26,VE,B,H,5,diff,283
1031,1171,140,1.140052873,1.958696696,745,620,1,395,'01_30_01.c3d',27,VE,B,H,1,diff,125
1180,1354,174,1.135526523,1.503914397,829,658,448,393,'01_30_02.c3d',27,VE,B,H,2,diff,171
3104,3455,351,0.64096965,0.847335046,1059,791,1,5,'01_30_03.c3d',27,VE,B,H,3,diff,268
1364,1921,557,0.761955627,1.398260023,895,533,349,36,'01_30_04.c3d',27,VE,B,H,4,diff,362
1506,1777,271,0.776689826,1.107215686,969,644,402,393,'01_30_05.c3d',27,VE,B,H,5,diff,325
2042,2692,650,0.634412984,0.709077826,1600,1110,896,1,'01_30_01.c3d',28,VE,B,H,1,diff,490
1329,1834,505,0.671810829,0.988914579,1192,445,268,242,'01_30_02.c3d',28,VE,B,H,2,diff,747
1299,1661,362,0.835263346,0.982568093,1044,1102,1,369,'01_30_03.c3d',28,VE,B,H,3,diff,58
1658,1811,153,0.537022642,0.699662642,998,491,261,240,'01_30_04.c3d',28,VE,B,H,4,diff,507
1773,1932,159,0.670733499,0.968527178,1477,1334,1,14,'01_30_05.c3d',28,VE,B,H,5,diff,143
1140,2271,1131,0.856162354,1.510534363,858,569,410,1,'01_30_01.c3d',29,VE,B,H,1,diff,289
925,1029,104,0.874035383,1.625013845,782,463,269,1,'01_30_02.c3d',29,VE,B,H,2,diff,319
977,1071,94,0.902693238,1.628539475,711,477,293,92,'01_30_03.c3d',29,VE,B,H,3,diff,234
1230,1391,161,0.633713327,1.111755909,842,426,1,211,'01_30_04.c3d',29,VE,B,H,4,diff,416
1159,1354,195,0.818728585,1.281001872,839,504,1,62,'01_30_05.c3d',29,VE,B,H,5,diff,335
1456,1810,354,0.787425891,1.37727239,822,572,354,1,'01_30_01.c3d',30,VE,B,H,1,diff,250
946,1015,69,1.14933622,1.577751449,843,588,22,388,'01_30_02.c3d',30,VE,B,H,2,diff,255
969,1216,247,0.852889441,1.48088741,755,529,1,327,'01_30_03.c3d',30,VE,B,H,3,diff,226
952,954,2,0.855266461,1.179088605,721,460,1,86,'01_30_04.c3d',30,VE,B,H,4,diff,261
1056,1717,661,0.751159006,0.80777155,763,449,1,89,'01_30_05.c3d',30,VE,B,H,5,diff,314
969,2237,1268,1.554388351,2.597019212,739,545,346,356,'01_30_01.c3d',31,VE,B,H,1,diff,194
1008,1201,193,1.535310888,1.755595643,772,541,336,343,'01_30_02.c3d',31,VE,B,H,2,diff,231
1104,1226,122,1.629021672,1.526551029,806,548,1,331,'01_30_03.c3d',31,VE,B,H,3,diff,258
822,1069,247,1.395883973,1.747966788,735,470,275,236,'01_30_04.c3d',31,VE,B,H,4,diff,265
931,975,44,1.565419595,2.331846954,728,512,325,319,'01_30_05.c3d',31,VE,B,H,5,diff,216
1048,1117,69,1.022486228,1.217810003,757,537,1,321,'01_30_01.c3d',32,VE,B,H,1,diff,220
1075,1739,664,1.009584068,1.687763213,759,504,293,292,'01_30_02.c3d',32,VE,B,H,2,diff,255
1262,1289,27,0.839062931,1.427950515,845,534,341,1,'01_30_03.c3d',32,VE,B,H,3,diff,311
1018,1116,98,0.889259155,1.511401991,709,473,287,276,'01_30_04.c3d',32,VE,B,H,4,diff,236
1047,2596,1549,0.973950546,1.18604567,797,524,280,17,'01_30_05.c3d',32,VE,B,H,5,diff,273
1378,1525,147,0.897601913,1.125088147,1082,688,435,386,'01_30_01.c3d',33,VE,B,H,1,diff,394
1525,1673,148,0.765653607,1.066735729,1118,750,509,15,'01_30_02.c3d',33,VE,B,H,2,diff,368
1185,1408,223,0.960267309,1.23147677,867,551,356,333,'01_30_03.c3d',33,VE,B,H,3,diff,316
1515,2164,649,0.822553638,0.960268076,1045,689,1,76,'01_30_04.c3d',33,VE,B,H,4,diff,356
1486,2284,798,0.774615582,0.898357769,1050,628,372,9,'01_30_05.c3d',33,VE,B,H,5,diff,422
1060,1677,617,1.034720163,1.423671243,701,530,360,341,'01_30_01.c3d',34,VE,B,H,1,diff,171
1045,1092,47,1.096019713,1.718790043,737,585,375,18,'01_30_02.c3d',34,VE,B,H,2,diff,152
995,1093,98,1.014117813,1.397589255,715,444,287,289,'01_30_03.c3d',34,VE,B,H,3,diff,271
877,984,107,0.957133959,1.465957416,668,467,264,1,'01_30_04.c3d',34,VE,B,H,4,diff,201
1105,1315,210,1.020774218,1.170246925,776,510,317,41,'01_30_05.c3d',34,VE,B,H,5,diff,266
1113,1158,45,1.040997108,1.734841091,738,425,211,207,'01_30_01.c3d',35,VE,B,H,1,diff,313
811,986,175,0.922764525,1.177541005,573,425,1,1,'01_30_02.c3d',35,VE,B,H,2,diff,148
1229,1237,8,0.934681012,1.271293328,799,438,1,232,'01_30_03.c3d',35,VE,B,H,3,diff,361
1131,1173,42,1.071676315,1.626921666,737,524,286,1,'01_30_04.c3d',35,VE,B,H,4,diff,213
1058,1310,252,1.175584571,1.714298074,622,411,1,219,'01_30_05.c3d',35,VE,B,H,5,diff,211
888,972,84,0.464753736,1.197617584,629,510,1,44,'01_31_01.c3d',1,VE,L,E,1,diff,119
720,1141,421,0.61046354,0.993676899,600,469,224,52,'01_31_02.c3d',1,VE,L,E,2,diff,131
794,1057,263,0.604635141,1.819517797,738,555,1,297,'01_31_03.c3d',1,VE,L,E,3,diff,183
754,1796,1042,0.696506739,1.449689568,637,512,252,150,'01_31_04.c3d',1,VE,L,E,4,diff,125
857,1821,964,0.588858119,1.109626124,776,553,287,112,'01_31_05.c3d',1,VE,L,E,5,diff,223
820,1005,185,0.489603249,1.382971171,685,504,272,1,'01_31_01.c3d',2,VE,L,E,1,diff,181
842,1370,528,0.457033971,0.970173278,718,490,46,16,'01_31_02.c3d',2,VE,L,E,2,diff,228
749,1855,1106,0.595705504,0.915341226,619,518,237,1,'01_31_03.c3d',2,VE,L,E,3,diff,101
787,1339,552,0.550011549,1.339153831,639,560,1,1,'01_31_04.c3d',2,VE,L,E,4,diff,79
797,1587,790,0.660368166,1.196571575,719,546,281,47,'01_31_05.c3d',2,VE,L,E,5,diff,173
741,760,19,0.769634732,2.556049999,560,592,375,409,'01_31_01.c3d',3,VE,L,E,1,diff,32
84,712,628,1.575779339,1.724326125,1,12,1,1,'01_31_02.c3d',3,VE,L,E,2,diff,11
779,1127,348,0.775907703,1.722237317,552,438,267,1,'01_31_03.c3d',3,VE,L,E,3,diff,114
788,997,209,0.582479448,1.94823528,455,526,1,355,'01_31_04.c3d',3,VE,L,E,4,diff,71
698,908,210,0.804639236,1.44025005,624,483,322,327,'01_31_05.c3d',3,VE,L,E,5,diff,141
714,817,103,0.624434874,1.570361317,628,614,1,59,'01_31_01.c3d',4,VE,L,E,1,diff,14
831,2025,1194,0.403062949,1.1316208,632,453,1,205,'01_31_02.c3d',4,VE,L,E,2,diff,179
642,1495,853,0.824455546,1.554989739,625,490,282,253,'01_31_03.c3d',4,VE,L,E,3,diff,135
755,758,3,0.493489314,1.153021631,520,633,1,46,'01_31_04.c3d',4,VE,L,E,4,diff,113
588,1007,419,0.558964637,1.453253136,481,440,147,108,'01_31_05.c3d',4,VE,L,E,5,diff,41
1689,1701,12,1.216229914,2.715134902,562,577,418,1,'01_31_01.c3d',5,VE,L,E,1,diff,15
644,1053,409,1.155715011,2.831083057,430,498,1,306,'01_31_02.c3d',5,VE,L,E,2,diff,68
505,1085,580,1.300357735,3.309165497,364,420,259,256,'01_31_03.c3d',5,VE,L,E,3,diff,56
574,774,200,1.327774211,2.391839441,254,186,1,1,'01_31_04.c3d',5,VE,L,E,4,diff,68
588,703,115,0.885442683,2.984248481,382,472,207,129,'01_31_05.c3d',5,VE,L,E,5,diff,90
793,1438,645,0.505960541,1.68875453,640,1111,303,13,'01_31_01.c3d',6,VE,L,E,1,diff,471
744,1272,528,0.592073893,1.158048426,572,921,1,334,'01_31_02.c3d',6,VE,L,E,2,diff,349
739,1244,505,0.625966526,1.014157732,594,1034,1,1,'01_31_03.c3d',6,VE,L,E,3,diff,440
759,1116,357,0.548444602,1.564869489,583,496,1,87,'01_31_04.c3d',6,VE,L,E,4,diff,87
801,1700,899,0.561587636,0.740463584,658,478,1,1,'01_31_05.c3d',6,VE,L,E,5,diff,180
2640,3174,534,0.189793513,0.430957826,1978,2543,1,1,'01_31_01.c3d',7,VE,L,E,1,diff,565
1276,1668,392,0.309123778,0.561608974,1120,724,1,154,'01_31_02.c3d',7,VE,L,E,2,diff,396
732,1564,832,0.707495982,1.58305014,486,471,1,167,'01_31_03.c3d',7,VE,L,E,3,diff,15
406,1106,700,0.569687519,0.942274163,349,474,1,1,'01_31_04.c3d',7,VE,L,E,4,diff,125
611,1331,720,0.529868234,1.06290848,481,468,1,1,'01_31_05.c3d',7,VE,L,E,5,diff,13
842,1229,387,0.474458031,1.255783193,720,490,212,230,'01_31_01.c3d',8,VE,L,E,1,diff,230
1660,2189,529,0.456327686,0.959545381,1533,1280,777,1,'01_31_02.c3d',8,VE,L,E,2,diff,253
954,1204,250,0.473632168,0.949803487,695,637,296,63,'01_31_03.c3d',8,VE,L,E,3,diff,58
797,1227,430,0.549176919,1.16042731,702,616,1,14,'01_31_04.c3d',8,VE,L,E,4,diff,86
878,1267,389,0.508022271,1.171927531,792,560,249,7,'01_31_05.c3d',8,VE,L,E,5,diff,232
860,1055,195,0.519877588,2.238313084,540,472,20,1,'01_31_01.c3d',9,VE,L,E,1,diff,68
695,1741,1046,0.61462079,1.561135826,547,447,249,270,'01_31_02.c3d',9,VE,L,E,2,diff,100
704,855,151,0.604607254,1.820150629,449,405,1,239,'01_31_03.c3d',9,VE,L,E,3,diff,44
692,1490,798,0.637655002,1.57981067,616,544,270,281,'01_31_04.c3d',9,VE,L,E,4,diff,72
1158,1372,214,0.656078962,1.924193259,495,461,234,247,'01_31_05.c3d',9,VE,L,E,5,diff,34
945,1635,690,0.464317255,3.451069234,776,789,634,584,'01_31_01.c3d',10,VE,L,E,1,diff,13
725,1730,1005,0.684005763,2.039755449,525,465,1,263,'01_31_02.c3d',10,VE,L,E,2,diff,60
843,1019,176,0.645987061,2.252553047,647,555,173,344,'01_31_03.c3d',10,VE,L,E,3,diff,92
683,880,197,0.697640894,1.728550199,545,554,262,268,'01_31_04.c3d',10,VE,L,E,4,diff,9
747,757,10,0.538734103,2.093316225,459,544,1,1,'01_31_05.c3d',10,VE,L,E,5,diff,85
1152,1258,106,0.552227044,1.406011726,768,626,353,1,'01_31_01.c3d',11,VE,L,E,1,diff,142
865,1462,597,0.522651757,0.907828593,744,614,1,1,'01_31_02.c3d',11,VE,L,E,2,diff,130
1399,2293,894,0.245624142,0.532305311,1256,708,1,29,'01_31_03.c3d',11,VE,L,E,3,diff,548
1213,1803,590,0.298193811,0.619272906,977,649,77,204,'01_31_04.c3d',11,VE,L,E,4,diff,328
1338,1903,565,0.385139684,0.740642767,1161,792,516,1,'01_31_05.c3d',11,VE,L,E,5,diff,369
992,1335,343,0.509774531,1.151253177,704,500,264,271,'01_31_01.c3d',12,VE,L,E,1,diff,204
1022,1134,112,0.582722109,1.814084335,475,531,1,336,'01_31_02.c3d',12,VE,L,E,2,diff,56
936,1941,1005,0.690795264,1.453280997,583,497,243,252,'01_31_03.c3d',12,VE,L,E,3,diff,86
575,889,314,0.770990265,1.633924925,396,480,247,280,'01_31_04.c3d',12,VE,L,E,4,diff,84
563,923,360,0.761090762,1.881754901,390,462,182,267,'01_31_05.c3d',12,VE,L,E,5,diff,72
587,1491,904,0.741277585,1.877118071,531,452,192,1,'01_31_01.c3d',13,VE,L,E,1,diff,79
839,1366,527,0.687015756,1.278681465,731,635,218,347,'01_31_02.c3d',13,VE,L,E,2,diff,96
614,1084,470,0.71088397,1.547208259,459,499,1,53,'01_31_03.c3d',13,VE,L,E,3,diff,40
751,984,233,0.707860832,1.637236461,654,588,1,41,'01_31_04.c3d',13,VE,L,E,4,diff,66
637,1028,391,0.79066629,1.868836176,505,510,1,82,'01_31_05.c3d',13,VE,L,E,5,diff,5
528,859,331,0.914829946,2.884998986,371,452,215,236,'01_31_01.c3d',14,VE,L,E,1,diff,81
545,835,290,0.988552548,2.804367914,410,482,1,246,'01_31_02.c3d',14,VE,L,E,2,diff,72
705,768,63,1.078214054,2.95213962,351,405,213,241,'01_31_03.c3d',14,VE,L,E,3,diff,54
338,982,644,0.873495928,1.846162691,262,395,1,1,'01_31_04.c3d',14,VE,L,E,4,diff,133
642,912,270,0.675222469,1.718850699,378,510,1,23,'01_31_05.c3d',14,VE,L,E,5,diff,132
631,791,160,0.75771134,2.150902324,417,515,1,58,'01_31_01.c3d',15,VE,L,E,1,diff,98
532,733,201,0.723766376,1.318986817,304,402,50,1,'01_31_02.c3d',15,VE,L,E,2,diff,98
482,786,304,0.664129537,1.334419186,337,451,1,42,'01_31_03.c3d',15,VE,L,E,3,diff,114
780,920,140,0.538533503,1.526412713,414,546,249,272,'01_31_04.c3d',15,VE,L,E,4,diff,132
870,1015,145,0.521184417,1.516595781,424,536,246,263,'01_31_05.c3d',15,VE,L,E,5,diff,112
772,1681,909,0.743497847,2.42036797,653,515,296,322,'01_31_01.c3d',16,VE,L,E,1,diff,138
743,875,132,0.564478263,1.586194804,526,443,201,127,'01_31_02.c3d',16,VE,L,E,2,diff,83
836,1377,541,0.495176355,1.777279991,458,444,1,38,'01_31_03.c3d',16,VE,L,E,3,diff,14
491,1848,1357,0.715408199,1.945154721,390,387,87,114,'01_31_04.c3d',16,VE,L,E,4,diff,3
877,1072,195,0.451873908,1.391313382,427,569,1,24,'01_31_05.c3d',16,VE,L,E,5,diff,142
435,711,276,1.349505685,3.87361552,342,389,231,248,'01_31_01.c3d',17,VE,L,E,1,diff,47
444,794,350,1.417334906,3.680249003,344,383,249,257,'01_31_02.c3d',17,VE,L,E,2,diff,39
547,709,162,1.211620047,2.996447512,416,479,308,1,'01_31_03.c3d',17,VE,L,E,3,diff,63
472,831,359,1.178137929,3.229634704,357,400,241,249,'01_31_04.c3d',17,VE,L,E,4,diff,43
498,647,149,1.190442793,3.175079746,498,405,244,266,'01_31_05.c3d',17,VE,L,E,5,diff,93
1010,1467,457,0.847273802,2.866889191,464,495,1,32,'01_31_01.c3d',18,VE,L,E,1,diff,31
557,1854,1297,0.762404171,1.907533605,562,488,1,56,'01_31_02.c3d',18,VE,L,E,2,diff,74
1056,2152,1096,0.805218421,1.753239049,659,487,1,290,'01_31_03.c3d',18,VE,L,E,3,diff,172
780,1036,256,0.668803535,2.152703379,676,561,1,330,'01_31_04.c3d',18,VE,L,E,4,diff,115
820,1676,856,0.606755399,1.403045725,704,637,1,1,'01_31_05.c3d',18,VE,L,E,5,diff,67
937,1407,470,0.424688802,0.778039654,734,513,1,1,'01_31_01.c3d',19,VE,L,E,1,diff,221
754,975,221,0.603709888,1.609293961,694,541,1,321,'01_31_02.c3d',19,VE,L,E,2,diff,153
812,918,106,0.485562222,1.740093434,732,487,236,1,'01_31_03.c3d',19,VE,L,E,3,diff,245
916,1029,113,0.553320884,1.768989191,683,542,1,298,'01_31_04.c3d',19,VE,L,E,4,diff,141
651,929,278,0.741451771,1.971957897,596,503,1,1,'01_31_05.c3d',19,VE,L,E,5,diff,93
670,1206,536,0.717888213,1.778050389,561,468,256,268,'01_31_01.c3d',20,VE,L,E,1,diff,93
829,1454,625,0.61922885,1.45362693,672,527,323,316,'01_31_02.c3d',20,VE,L,E,2,diff,145
740,1266,526,0.68153325,1.406495755,601,439,248,212,'01_31_03.c3d',20,VE,L,E,3,diff,162
1125,1259,134,0.571562636,0.91939529,340,421,1,1,'01_31_04.c3d',20,VE,L,E,4,diff,81
743,977,234,0.699835321,1.76649136,565,460,273,273,'01_31_05.c3d',20,VE,L,E,5,diff,105
834,1143,309,0.45594664,1.340871294,576,649,1,82,'01_31_01.c3d',21,VE,L,E,1,diff,73
729,1132,403,0.612328205,1.460042991,604,529,1,302,'01_31_02.c3d',21,VE,L,E,2,diff,75
841,998,157,0.453334682,1.271823172,503,449,1,228,'01_31_03.c3d',21,VE,L,E,3,diff,54
888,1374,486,0.615660254,1.224010167,768,715,427,429,'01_31_04.c3d',21,VE,L,E,4,diff,53
969,1426,457,0.468195351,0.913173796,694,554,148,351,'01_31_05.c3d',21,VE,L,E,5,diff,140
726,1226,500,0.835016557,1.538733028,622,923,316,354,'01_31_01.c3d',22,VE,L,E,1,diff,301
784,1339,555,0.772215197,1.318616226,642,1086,1,398,'01_31_02.c3d',22,VE,L,E,2,diff,444
845,1614,769,0.582731003,1.699433421,645,1233,295,369,'01_31_03.c3d',22,VE,L,E,3,diff,588
757,1618,861,0.600487795,1.173526954,566,1261,241,612,'01_31_04.c3d',22,VE,L,E,4,diff,695
817,1287,470,0.575868981,1.122121198,647,676,286,311,'01_31_05.c3d',22,VE,L,E,5,diff,29
885,2524,1639,0.397408814,0.853629383,738,1309,33,52,'01_31_01.c3d',23,VE,L,E,1,diff,571
1098,2187,1089,0.333841525,0.993203868,886,575,14,79,'01_31_02.c3d',23,VE,L,E,2,diff,311
1370,4881,3511,0.358601881,0.662143353,1315,1362,388,32,'01_31_03.c3d',23,VE,L,E,3,diff,47
2472,4190,1718,0.298383897,0.776494451,1114,1782,260,284,'01_31_04.c3d',23,VE,L,E,4,diff,668
1193,1869,676,0.350103252,0.860976052,770,1352,294,340,'01_31_05.c3d',23,VE,L,E,5,diff,582
1010,1763,753,0.54260086,1.244213026,795,723,1,1,'01_31_01.c3d',24,VE,L,E,1,diff,72
608,1006,398,0.830115564,1.834743196,535,525,1,251,'01_31_02.c3d',24,VE,L,E,2,diff,10
638,1084,446,0.686535518,1.866051595,563,514,95,234,'01_31_03.c3d',24,VE,L,E,3,diff,49
740,875,135,0.529702652,1.661450543,529,484,217,107,'01_31_04.c3d',24,VE,L,E,4,diff,45
652,985,333,0.679634229,1.500256262,595,507,225,221,'01_31_05.c3d',24,VE,L,E,5,diff,88
685,789,104,0.711943352,1.803842771,540,517,1,289,'01_31_01.c3d',25,VE,L,E,1,diff,23
752,1343,591,0.775642166,1.098274987,660,672,242,301,'01_31_02.c3d',25,VE,L,E,2,diff,12
731,1118,387,0.645500287,1.054618858,566,484,259,272,'01_31_03.c3d',25,VE,L,E,3,diff,82
819,991,172,0.542444831,1.418401863,504,506,1,36,'01_31_04.c3d',25,VE,L,E,4,diff,2
633,1446,813,0.561064703,1.061806833,457,381,137,168,'01_31_05.c3d',25,VE,L,E,5,diff,76
798,1971,1173,0.423896632,1.368276188,681,587,1,302,'01_31_01.c3d',26,VE,L,E,1,diff,94
1165,1780,615,0.49802684,1.408157558,688,563,290,82,'01_31_02.c3d',26,VE,L,E,2,diff,125
994,1143,149,0.293716269,0.943970076,726,559,75,353,'01_31_03.c3d',26,VE,L,E,3,diff,167
1127,1636,509,0.399792537,1.445850041,499,600,1,258,'01_31_04.c3d',26,VE,L,E,4,diff,101
1477,1800,323,0.277115672,0.639932935,932,1286,1,7,'01_31_05.c3d',26,VE,L,E,5,diff,354
970,1748,778,0.607216755,1.573584344,900,641,425,78,'01_31_01.c3d',27,VE,L,E,1,diff,259
879,1132,253,0.763904733,2.338609632,739,667,451,456,'01_31_02.c3d',27,VE,L,E,2,diff,72
1042,1362,320,0.48275426,1.06134827,771,539,324,90,'01_31_03.c3d',27,VE,L,E,3,diff,232
1274,1548,274,0.597937263,1.054587705,1002,939,631,571,'01_31_04.c3d',27,VE,L,E,4,diff,63
797,1143,346,0.796401573,1.395848797,716,607,339,352,'01_31_05.c3d',27,VE,L,E,5,diff,109
947,1450,503,0.499949456,0.706582474,813,1004,1,245,'01_31_01.c3d',28,VE,L,E,1,diff,191
961,2169,1208,0.416752282,0.777327943,717,904,223,1,'01_31_02.c3d',28,VE,L,E,2,diff,187
879,1797,918,0.581024985,1.079525314,678,1717,317,1,'01_31_03.c3d',28,VE,L,E,3,diff,1039
1094,1505,411,0.444420432,0.893105455,1031,1118,420,1,'01_31_04.c3d',28,VE,L,E,4,diff,87
921,1065,144,0.468173234,1.248319674,667,596,241,269,'01_31_05.c3d',28,VE,L,E,5,diff,71
632,1329,697,0.691090502,2.05062642,551,476,1,1,'01_31_01.c3d',29,VE,L,E,1,diff,75
1508,1516,8,0.666379722,2.04287324,564,479,1,274,'01_31_02.c3d',29,VE,L,E,2,diff,85
996,1159,163,0.756377322,1.812050261,553,547,1,16,'01_31_03.c3d',29,VE,L,E,3,diff,6
627,974,347,0.579604578,1.453637245,448,446,1,213,'01_31_04.c3d',29,VE,L,E,4,diff,2
635,1743,1108,0.579497785,1.575650367,586,467,1,1,'01_31_05.c3d',29,VE,L,E,5,diff,119
872,953,81,0.577962224,1.792143691,740,672,1,66,'01_31_01.c3d',30,VE,L,E,1,diff,68
1013,1125,112,0.371984615,1.159877252,789,571,1,1,'01_31_02.c3d',30,VE,L,E,2,diff,218
877,1050,173,0.497838685,1.45604839,710,601,380,382,'01_31_03.c3d',30,VE,L,E,3,diff,109
750,1338,588,0.547546888,0.89771983,583,563,58,1,'01_31_04.c3d',30,VE,L,E,4,diff,20
749,953,204,0.461191275,1.128747179,492,483,12,208,'01_31_05.c3d',30,VE,L,E,5,diff,9
594,1905,1311,1.245885503,3.001766866,562,499,294,320,'01_31_01.c3d',31,VE,L,E,1,diff,63
830,928,98,0.684533447,1.817603497,544,499,262,283,'01_31_02.c3d',31,VE,L,E,2,diff,45
662,1548,886,1.085138828,2.272388498,558,478,282,284,'01_31_03.c3d',31,VE,L,E,3,diff,80
787,1136,349,0.756313477,1.972517706,608,557,319,44,'01_31_04.c3d',31,VE,L,E,4,diff,51
669,970,301,0.885424446,1.806543141,540,492,235,266,'01_31_05.c3d',31,VE,L,E,5,diff,48
818,1294,476,0.620412917,1.748296441,755,619,1,386,'01_31_01.c3d',32,VE,L,E,1,diff,136
740,787,47,0.629497305,1.62734232,588,512,246,268,'01_31_02.c3d',32,VE,L,E,2,diff,76
785,920,135,0.60275416,1.482535615,600,531,262,1,'01_31_03.c3d',32,VE,L,E,3,diff,69
683,755,72,0.646675764,1.6043071,615,513,249,285,'01_31_04.c3d',32,VE,L,E,4,diff,102
1003,1570,567,0.546715357,1.235227671,682,605,1,321,'01_31_05.c3d',32,VE,L,E,5,diff,77
879,1259,380,0.778538947,1.152735007,745,670,1,297,'01_31_01.c3d',33,VE,L,E,1,diff,75
915,1122,207,0.586141041,1.184921715,739,586,335,326,'01_31_02.c3d',33,VE,L,E,2,diff,153
874,1126,252,0.626574947,1.27531992,726,571,305,310,'01_31_03.c3d',33,VE,L,E,3,diff,155
885,1052,167,0.580950828,1.281912119,657,569,1,313,'01_31_04.c3d',33,VE,L,E,4,diff,88
866,1460,594,0.661778039,1.51235809,787,590,369,360,'01_31_05.c3d',33,VE,L,E,5,diff,197
784,1236,452,0.681136752,1.337880726,706,573,1,383,'01_31_01.c3d',34,VE,L,E,1,diff,133
626,875,249,0.63766335,1.361836018,527,458,239,216,'01_31_02.c3d',34,VE,L,E,2,diff,69
720,1191,471,0.625987208,1.267530799,629,475,256,271,'01_31_03.c3d',34,VE,L,E,3,diff,154
647,827,180,0.526326951,1.304043402,582,415,1,69,'01_31_04.c3d',34,VE,L,E,4,diff,167
797,1273,476,0.519925862,1.289774595,693,495,303,301,'01_31_05.c3d',34,VE,L,E,5,diff,198
581,1251,670,0.831892706,2.25775356,515,508,185,228,'01_31_01.c3d',35,VE,L,E,1,diff,7
500,871,371,0.774815185,1.498874384,407,383,13,14,'01_31_02.c3d',35,VE,L,E,2,diff,24
522,833,311,0.716312809,1.283874326,313,518,1,1,'01_31_03.c3d',35,VE,L,E,3,diff,205
1180,1340,160,0.778623158,1.838892367,848,855,1,1,'01_31_04.c3d',35,VE,L,E,4,diff,7
578,745,167,0.773752802,1.79190099,493,407,71,101,'01_31_05.c3d',35,VE,L,E,5,diff,86
915,1489,574,0.5349297,1.36608726,537,491,1,138,'01_32_01.c3d',1,VE,L,M,1,diff,46
984,2135,1151,0.501356371,1.312194234,804,516,1,267,'01_32_02.c3d',1,VE,L,M,2,diff,288
1004,1123,119,0.4074538,0.99839049,854,451,1,69,'01_32_03.c3d',1,VE,L,M,3,diff,403
713,974,261,0.553323703,1.584617864,619,510,1,103,'01_32_04.c3d',1,VE,L,M,4,diff,109
791,1056,265,0.528715873,1.161856764,707,532,1,1,'01_32_05.c3d',1,VE,L,M,5,diff,175
1371,2974,1603,0.46592413,1.405269901,1252,1110,1,377,'01_32_01.c3d',2,VE,L,M,1,diff,142
793,1474,681,0.595296351,1.044086771,716,865,298,1,'01_32_02.c3d',2,VE,L,M,2,diff,149
907,1430,523,0.49356577,1.172330625,769,583,1,1,'01_32_03.c3d',2,VE,L,M,3,diff,186
825,1509,684,0.575045494,1.086779921,783,534,311,282,'01_32_04.c3d',2,VE,L,M,4,diff,249
868,1927,1059,0.489681319,1.157275205,610,1389,221,23,'01_32_05.c3d',2,VE,L,M,5,diff,779
834,1245,411,0.611883669,2.210890994,559,488,283,21,'01_32_01.c3d',3,VE,L,M,1,diff,71
738,793,55,0.677578648,1.881697563,512,403,220,268,'01_32_02.c3d',3,VE,L,M,2,diff,109
810,839,29,0.647367816,1.731245404,530,794,1,1,'01_32_03.c3d',3,VE,L,M,3,diff,264
797,1211,414,0.525702549,1.579443708,519,1036,1,310,'01_32_04.c3d',3,VE,L,M,4,diff,517
689,749,60,0.691812944,2.143631069,568,592,281,1,'01_32_05.c3d',3,VE,L,M,5,diff,24
719,946,227,0.719380437,1.33128353,598,503,309,1,'01_32_01.c3d',4,VE,L,M,1,diff,95
706,1399,693,0.612916353,1.744988758,646,602,333,348,'01_32_02.c3d',4,VE,L,M,2,diff,44
754,827,73,0.586116117,1.532221763,653,569,302,1,'01_32_03.c3d',4,VE,L,M,3,diff,84
731,913,182,0.442376092,1.481918233,586,492,1,56,'01_32_04.c3d',4,VE,L,M,4,diff,94
766,1625,859,0.512539017,1.230527134,700,552,1,38,'01_32_05.c3d',4,VE,L,M,5,diff,148
1301,1536,235,0.838716233,2.772062363,765,714,1,489,'01_32_01.c3d',5,VE,L,M,1,diff,51
738,854,116,0.933259743,2.403592562,557,463,1,53,'01_32_02.c3d',5,VE,L,M,2,diff,94
655,927,272,0.842999358,3.089725023,375,417,1,259,'01_32_03.c3d',5,VE,L,M,3,diff,42
767,1058,291,0.797047582,3.193103118,569,571,1,1,'01_32_04.c3d',5,VE,L,M,4,diff,2
654,812,158,0.892515377,2.544442693,553,437,245,262,'01_32_05.c3d',5,VE,L,M,5,diff,116
863,1738,875,0.513977057,1.536147888,728,1320,391,410,'01_32_01.c3d',6,VE,L,M,1,diff,592
716,966,250,0.578775887,1.325165162,606,496,261,255,'01_32_02.c3d',6,VE,L,M,2,diff,110
804,1271,467,0.569098709,1.416876751,665,902,1,361,'01_32_03.c3d',6,VE,L,M,3,diff,237
799,1486,687,0.557547189,1.118610215,607,478,1,279,'01_32_04.c3d',6,VE,L,M,4,diff,129
781,1198,417,0.53398847,0.853751923,589,481,1,25,'01_32_05.c3d',6,VE,L,M,5,diff,108
816,948,132,0.476446943,1.113281593,597,517,209,24,'01_32_01.c3d',7,VE,L,M,1,diff,80
708,1070,362,0.513426645,1.142881216,516,517,252,37,'01_32_02.c3d',7,VE,L,M,2,diff,1
752,819,67,0.516302777,1.618182334,512,479,1,1,'01_32_03.c3d',7,VE,L,M,3,diff,33
625,1171,546,0.595274538,1.070309348,453,451,1,91,'01_32_04.c3d',7,VE,L,M,4,diff,2
568,1446,878,0.403536578,0.784063698,400,452,1,1,'01_32_05.c3d',7,VE,L,M,5,diff,52
938,2982,2044,0.465824561,1.010392693,557,546,1,369,'01_32_01.c3d',8,VE,L,M,1,diff,11
947,1501,554,0.440244498,1.377607235,765,559,1,138,'01_32_02.c3d',8,VE,L,M,2,diff,206
988,1293,305,0.527415432,1.133250869,811,628,371,396,'01_32_03.c3d',8,VE,L,M,3,diff,183
873,1290,417,0.384790668,0.964802134,496,457,57,1,'01_32_04.c3d',8,VE,L,M,4,diff,39
1020,2217,1197,0.39902284,0.786565372,887,565,1,290,'01_32_05.c3d',8,VE,L,M,5,diff,322
802,1805,1003,0.595921446,1.517911133,614,506,273,319,'01_32_01.c3d',9,VE,L,M,1,diff,108
957,1820,863,0.541537975,1.737076229,702,492,1,293,'01_32_02.c3d',9,VE,L,M,2,diff,210
796,945,149,0.498093287,1.712309427,444,400,160,224,'01_32_03.c3d',9,VE,L,M,3,diff,44
1049,1804,755,0.646943072,1.444121459,641,483,265,264,'01_32_04.c3d',9,VE,L,M,4,diff,158
1070,1753,683,0.28409149,1.356977867,662,475,1,272,'01_32_05.c3d',9,VE,L,M,5,diff,187
924,1462,538,0.617445646,3.843501367,626,506,1,332,'01_32_01.c3d',10,VE,L,M,1,diff,120
909,920,11,0.576508317,2.821760796,644,503,278,303,'01_32_02.c3d',10,VE,L,M,2,diff,141
685,697,12,0.672470108,2.679804485,533,444,260,264,'01_32_03.c3d',10,VE,L,M,3,diff,89
1107,1974,867,0.404268823,1.456439139,778,631,294,412,'01_32_04.c3d',10,VE,L,M,4,diff,147
1006,1272,266,0.26558879,1.446717097,862,478,1,153,'01_32_05.c3d',10,VE,L,M,5,diff,384
1073,1972,899,0.385527219,0.897796834,899,653,352,1,'01_32_01.c3d',11,VE,L,M,1,diff,246
1222,1880,658,0.377397969,0.703698038,1073,703,386,1,'01_32_02.c3d',11,VE,L,M,2,diff,370
947,1847,900,0.489633642,0.704231278,867,681,1,57,'01_32_03.c3d',11,VE,L,M,3,diff,186
1428,5031,3603,0.267887381,0.51050741,1191,1725,407,1,'01_32_04.c3d',11,VE,L,M,4,diff,534
1313,1923,610,0.409631845,0.591368083,1109,982,530,34,'01_32_05.c3d',11,VE,L,M,5,diff,127
704,763,59,0.631100474,2.008046221,635,471,266,283,'01_32_01.c3d',12,VE,L,M,1,diff,164
755,1020,265,0.635526833,1.595384072,536,585,329,46,'01_32_02.c3d',12,VE,L,M,2,diff,49
721,851,130,0.675085851,1.874386319,545,550,1,81,'01_32_03.c3d',12,VE,L,M,3,diff,5
986,1068,82,0.619459573,1.606537715,557,484,1,288,'01_32_04.c3d',12,VE,L,M,4,diff,73
925,962,37,0.479624267,1.081637645,647,524,178,237,'01_32_05.c3d',12,VE,L,M,5,diff,123
1099,1927,828,0.49394622,1.155474363,883,863,1,6,'01_32_01.c3d',13,VE,L,M,1,diff,20
688,1304,616,0.580045309,1.392243447,574,437,1,1,'01_32_02.c3d',13,VE,L,M,2,diff,137
753,1016,263,0.592137645,1.791660943,605,486,253,1,'01_32_03.c3d',13,VE,L,M,3,diff,119
815,1462,647,0.558406259,1.500500187,676,585,280,338,'01_32_04.c3d',13,VE,L,M,4,diff,91
710,1181,471,0.57962684,1.608179117,523,502,1,260,'01_32_05.c3d',13,VE,L,M,5,diff,21
870,1531,661,0.671980895,1.454006348,615,636,1,1,'01_32_01.c3d',14,VE,L,M,1,diff,21
636,1006,370,1.025561207,2.881378636,540,560,1,343,'01_32_02.c3d',14,VE,L,M,2,diff,20
547,633,86,0.841296226,2.849147441,400,422,1,243,'01_32_03.c3d',14,VE,L,M,3,diff,22
254,907,653,1.03762185,1.435042069,1,1,1,1,'01_32_04.c3d',14,VE,L,M,4,diff,0
555,1576,1021,0.791884241,2.096330057,366,442,32,131,'01_32_05.c3d',14,VE,L,M,5,diff,76
672,905,233,0.587044316,1.324474131,409,472,251,59,'01_32_01.c3d',15,VE,L,M,1,diff,63
499,1448,949,0.553288059,1.658432095,423,508,1,1,'01_32_02.c3d',15,VE,L,M,2,diff,85
2289,2962,673,0.582162495,1.36219632,2147,2020,1749,236,'01_32_03.c3d',15,VE,L,M,3,diff,127
702,999,297,0.529058612,1.33666615,593,481,23,74,'01_32_04.c3d',15,VE,L,M,4,diff,112
406,884,478,0.615934698,1.264695233,311,464,1,1,'01_32_05.c3d',15,VE,L,M,5,diff,153
786,1493,707,0.676053343,1.600421902,529,511,1,266,'01_32_01.c3d',16,VE,L,M,1,diff,18
853,1024,171,0.574476629,1.578883339,619,502,1,1,'01_32_02.c3d',16,VE,L,M,2,diff,117
913,967,54,0.399379937,1.809430524,386,439,1,67,'01_32_03.c3d',16,VE,L,M,3,diff,53
812,852,40,0.601013427,1.597814719,550,495,1,249,'01_32_04.c3d',16,VE,L,M,4,diff,55
993,1135,142,0.450307618,1.216641711,556,455,1,246,'01_32_05.c3d',16,VE,L,M,5,diff,101
727,1224,497,0.637648766,1.412142644,630,609,1,1,'01_32_01.c3d',17,VE,L,M,1,diff,21
741,773,32,0.813441068,2.535551778,596,525,123,373,'01_32_02.c3d',17,VE,L,M,2,diff,71
751,978,227,0.892667419,2.439572581,506,458,1,310,'01_32_03.c3d',17,VE,L,M,3,diff,48
717,876,159,1.04740369,2.655618532,424,405,238,99,'01_32_04.c3d',17,VE,L,M,4,diff,19
564,1296,732,0.779694768,2.22079815,378,435,1,1,'01_32_05.c3d',17,VE,L,M,5,diff,57
881,1820,939,0.81092957,2.477885057,610,516,1,318,'01_32_01.c3d',18,VE,L,M,1,diff,94
678,2435,1757,0.660555138,1.83910175,627,557,1,1,'01_32_02.c3d',18,VE,L,M,2,diff,70
626,718,92,0.550280342,2.347084861,574,482,1,77,'01_32_03.c3d',18,VE,L,M,3,diff,92
766,964,198,0.690570257,1.677869832,449,566,1,51,'01_32_04.c3d',18,VE,L,M,4,diff,117
484,606,122,0.530881749,1.991556925,478,487,1,1,'01_32_05.c3d',18,VE,L,M,5,diff,9
820,895,75,0.473492932,1.548485129,720,451,1,1,'01_32_01.c3d',19,VE,L,M,1,diff,269
748,1200,452,0.585070789,1.315585024,599,390,206,231,'01_32_02.c3d',19,VE,L,M,2,diff,209
762,864,102,0.5517008,1.560851393,624,484,1,80,'01_32_03.c3d',19,VE,L,M,3,diff,140
847,876,29,0.618225807,2.00209372,507,500,1,144,'01_32_04.c3d',19,VE,L,M,4,diff,7
665,744,79,0.600978135,1.608987226,488,496,1,241,'01_32_05.c3d',19,VE,L,M,5,diff,8
713,1337,624,0.746580741,1.916724767,678,435,270,262,'01_32_01.c3d',20,VE,L,M,1,diff,243
917,1849,932,0.637506292,1.471307277,638,473,1,259,'01_32_02.c3d',20,VE,L,M,2,diff,165
663,1071,408,0.739344754,1.566598742,556,445,248,89,'01_32_03.c3d',20,VE,L,M,3,diff,111
945,1640,695,0.540497333,1.009781091,771,511,347,1,'01_32_04.c3d',20,VE,L,M,4,diff,260
873,1341,468,0.517476116,1.182220826,698,442,265,92,'01_32_05.c3d',20,VE,L,M,5,diff,256
795,1775,980,0.592212895,0.936518361,732,887,1,1,'01_32_01.c3d',21,VE,L,M,1,diff,155
882,1137,255,0.504970776,1.219931568,775,578,1,344,'01_32_02.c3d',21,VE,L,M,2,diff,197
745,1169,424,0.619966617,1.328073448,629,490,275,269,'01_32_03.c3d',21,VE,L,M,3,diff,139
955,1051,96,0.403137332,1.38597253,628,541,1,42,'01_32_04.c3d',21,VE,L,M,4,diff,87
845,1312,467,0.500002851,0.80617216,687,533,273,269,'01_32_05.c3d',21,VE,L,M,5,diff,154
812,1386,574,0.651464341,1.320197443,669,1326,322,381,'01_32_01.c3d',22,VE,L,M,1,diff,657
847,1321,474,0.585891058,1.183084847,661,850,1,321,'01_32_02.c3d',22,VE,L,M,2,diff,189
883,1703,820,0.567352787,1.183550641,752,1119,290,350,'01_32_03.c3d',22,VE,L,M,3,diff,367
880,1534,654,0.616182431,0.86949106,680,950,1,317,'01_32_04.c3d',22,VE,L,M,4,diff,270
998,1589,591,0.47517717,1.038533183,734,968,358,371,'01_32_05.c3d',22,VE,L,M,5,diff,234
1090,1970,880,0.311820612,0.786445354,889,560,267,269,'01_32_01.c3d',23,VE,L,M,1,diff,329
1353,4277,2924,0.256503273,0.729828262,1166,1924,1,1,'01_32_02.c3d',23,VE,L,M,2,diff,758
1312,3542,2230,0.271228859,0.600682878,1185,2274,295,320,'01_32_03.c3d',23,VE,L,M,3,diff,1089
1272,4709,3437,0.372878973,0.380196553,929,1109,362,3,'01_32_04.c3d',23,VE,L,M,4,diff,180
1154,2865,1711,0.35906532,0.459599463,947,2820,1,331,'01_32_05.c3d',23,VE,L,M,5,diff,1873
1075,1338,263,0.499249369,1.467660455,691,627,376,1,'01_32_01.c3d',24,VE,L,M,1,diff,64
754,844,90,0.639503596,1.599179964,619,555,1,47,'01_32_02.c3d',24,VE,L,M,2,diff,64
639,843,204,0.548440929,1.616048473,471,413,1,26,'01_32_03.c3d',24,VE,L,M,3,diff,58
728,1368,640,0.578289148,1.233654232,521,466,120,159,'01_32_04.c3d',24,VE,L,M,4,diff,55
856,1448,592,0.477869601,1.113047219,774,506,286,298,'01_32_05.c3d',24,VE,L,M,5,diff,268
1028,1422,394,0.377874673,1.018371421,894,614,1,379,'01_32_01.c3d',25,VE,L,M,1,diff,280
708,1037,329,0.475526042,1.239713823,399,466,208,68,'01_32_02.c3d',25,VE,L,M,2,diff,67
896,1299,403,0.459758073,1.046061817,667,484,1,259,'01_32_03.c3d',25,VE,L,M,3,diff,183
1150,1325,175,0.370816551,1.091333382,795,660,1,422,'01_32_04.c3d',25,VE,L,M,4,diff,135
728,1470,742,0.611432481,1.477657306,633,495,1,288,'01_32_05.c3d',25,VE,L,M,5,diff,138
938,2062,1124,0.414069864,1.431910667,732,583,1,361,'01_32_01.c3d',26,VE,L,M,1,diff,149
1017,1227,210,0.322588767,1.650310326,549,553,347,336,'01_32_02.c3d',26,VE,L,M,2,diff,4
1166,1240,74,0.331172948,1.406682956,482,566,1,1,'01_32_03.c3d',26,VE,L,M,3,diff,84
1443,1604,161,0.265884164,0.807756831,742,589,1,42,'01_32_04.c3d',26,VE,L,M,4,diff,153
806,948,142,0.438287287,1.075680071,635,488,205,118,'01_32_05.c3d',26,VE,L,M,5,diff,147
843,1134,291,0.708640217,1.914892981,623,538,339,305,'01_32_01.c3d',27,VE,L,M,1,diff,85
1124,1340,216,0.543191937,0.99934852,803,616,1,62,'01_32_02.c3d',27,VE,L,M,2,diff,187
1282,1628,346,0.500082937,1.249762233,983,772,1,1,'01_32_03.c3d',27,VE,L,M,3,diff,211
1043,1423,380,0.519222711,0.985038441,860,614,1,315,'01_32_04.c3d',27,VE,L,M,4,diff,246
903,1774,871,0.587423089,1.058302179,720,581,328,325,'01_32_05.c3d',27,VE,L,M,5,diff,139
1365,2800,1435,0.367729728,0.919649134,1031,1853,1,296,'01_32_01.c3d',28,VE,L,M,1,diff,822
902,2133,1231,0.467188164,1.344461426,688,1319,1,1113,'01_32_02.c3d',28,VE,L,M,2,diff,631
1029,1997,968,0.431296053,0.837524148,801,620,255,359,'01_32_03.c3d',28,VE,L,M,3,diff,181
968,1431,463,0.475562369,1.005751306,660,665,1,51,'01_32_04.c3d',28,VE,L,M,4,diff,5
1904,2270,366,0.429366295,1.014502314,1731,1471,1165,101,'01_32_05.c3d',28,VE,L,M,5,diff,260
613,1290,677,0.660227008,1.708205038,454,466,1,202,'01_32_01.c3d',29,VE,L,M,1,diff,12
733,1910,1177,0.579166789,1.899359006,532,487,1,1,'01_32_02.c3d',29,VE,L,M,2,diff,45
925,1428,503,0.476376936,1.100788934,735,594,1,1,'01_32_03.c3d',29,VE,L,M,3,diff,141
763,1821,1058,0.469410172,1.478109195,578,479,1,25,'01_32_04.c3d',29,VE,L,M,4,diff,99
861,2450,1589,0.449293081,1.043631962,774,486,1,1,'01_32_05.c3d',29,VE,L,M,5,diff,288
812,1012,200,0.574228676,1.523343347,651,593,290,335,'01_32_01.c3d',30,VE,L,M,1,diff,58
730,1351,621,0.641840042,1.64636775,532,501,276,290,'01_32_02.c3d',30,VE,L,M,2,diff,31
721,1333,612,0.582524942,1.399297094,551,495,1,295,'01_32_03.c3d',30,VE,L,M,3,diff,56
911,990,79,0.43236295,0.994297213,739,474,245,70,'01_32_04.c3d',30,VE,L,M,4,diff,265
769,965,196,0.404161911,0.918826291,377,513,16,28,'01_32_05.c3d',30,VE,L,M,5,diff,136
752,1081,329,1.042202783,1.982112561,687,573,358,357,'01_32_01.c3d',31,VE,L,M,1,diff,114
868,1596,728,1.044831592,2.104401723,812,705,476,512,'01_32_02.c3d',31,VE,L,M,2,diff,107
952,1524,572,0.853421298,1.746782227,851,703,489,494,'01_32_03.c3d',31,VE,L,M,3,diff,148
811,1094,283,0.655215062,1.60084063,587,482,270,271,'01_32_04.c3d',31,VE,L,M,4,diff,105
799,1337,538,0.663092331,1.360284984,658,531,296,290,'01_32_05.c3d',31,VE,L,M,5,diff,127
795,1167,372,0.578899082,1.745537289,706,514,307,305,'01_32_01.c3d',32,VE,L,M,1,diff,192
692,1001,309,0.687220085,1.628540072,619,511,1,71,'01_32_02.c3d',32,VE,L,M,2,diff,108
855,981,126,0.472328736,1.125518879,719,499,1,1,'01_32_03.c3d',32,VE,L,M,3,diff,220
1057,1658,601,0.502881968,1.149894968,738,510,1,283,'01_32_04.c3d',32,VE,L,M,4,diff,228
1084,1193,109,0.405464495,1.06040871,793,609,1,1,'01_32_05.c3d',32,VE,L,M,5,diff,184
1056,1213,157,0.611806987,1.160272379,862,659,411,381,'01_32_01.c3d',33,VE,L,M,1,diff,203
1151,1178,27,0.545398135,1.534815246,992,785,507,481,'01_32_02.c3d',33,VE,L,M,2,diff,207
941,1246,305,0.537353957,0.947056736,824,538,315,279,'01_32_03.c3d',33,VE,L,M,3,diff,286
866,1657,791,0.585316343,1.071900839,793,559,260,1,'01_32_04.c3d',33,VE,L,M,4,diff,234
1050,1763,713,0.553487387,0.87240394,847,704,437,59,'01_32_05.c3d',33,VE,L,M,5,diff,143
785,1485,700,0.644488294,1.917119946,633,522,352,346,'01_32_01.c3d',34,VE,L,M,1,diff,111
758,762,4,0.66687317,1.950140775,603,541,320,331,'01_32_02.c3d',34,VE,L,M,2,diff,62
706,987,281,0.554073089,1.445672018,581,496,287,293,'01_32_03.c3d',34,VE,L,M,3,diff,85
869,946,77,0.427468207,1.070658858,562,472,1,60,'01_32_04.c3d',34,VE,L,M,4,diff,90
779,1219,440,0.536027514,1.188497879,630,463,1,92,'01_32_05.c3d',34,VE,L,M,5,diff,167
936,1109,173,0.653582744,1.59029554,725,605,425,423,'01_32_01.c3d',35,VE,L,M,1,diff,120
986,1511,525,0.70930399,1.885663587,506,461,219,242,'01_32_02.c3d',35,VE,L,M,2,diff,45
828,1155,327,0.78299479,1.639566299,724,631,1,398,'01_32_03.c3d',35,VE,L,M,3,diff,93
709,753,44,0.657501568,1.856314669,467,436,29,217,'01_32_04.c3d',35,VE,L,M,4,diff,31
691,1435,744,0.771324325,1.705215252,570,461,234,250,'01_32_05.c3d',35,VE,L,M,5,diff,109
2369,3519,1150,0.284271318,0.712396301,2176,1732,1,1103,'01_33_01.c3d',1,VE,L,H,1,diff,444
839,2174,1335,0.368273822,1.609903951,1395,507,1,244,'01_33_02.c3d',1,VE,L,H,2,diff,888
930,1857,927,0.490730619,1.27539291,806,617,1,286,'01_33_03.c3d',1,VE,L,H,3,diff,189
748,1116,368,0.426876148,1.625726744,660,620,1,1,'01_33_04.c3d',1,VE,L,H,4,diff,40
749,1625,876,0.659420616,1.598151912,571,577,166,1,'01_33_05.c3d',1,VE,L,H,5,diff,6
977,1463,486,0.378453435,1.140541395,728,509,1,51,'01_33_01.c3d',2,VE,L,H,1,diff,219
846,2051,1205,0.474026773,0.879897299,745,469,229,1,'01_33_02.c3d',2,VE,L,H,2,diff,276
852,1984,1132,0.456717981,0.763924313,790,1347,245,1,'01_33_03.c3d',2,VE,L,H,3,diff,557
1064,2581,1517,0.43806161,1.378962776,904,603,1,398,'01_33_04.c3d',2,VE,L,H,4,diff,301
889,3256,2367,0.463108902,1.214602231,736,519,1,47,'01_33_05.c3d',2,VE,L,H,5,diff,217
1065,1452,387,0.628660758,1.546449961,971,784,1,135,'01_33_01.c3d',3,VE,L,H,1,diff,187
657,888,231,0.729751324,1.679530263,418,478,1,5,'01_33_02.c3d',3,VE,L,H,2,diff,60
658,867,209,0.583408111,1.349230213,465,400,1,100,'01_33_03.c3d',3,VE,L,H,3,diff,65
754,900,146,0.551072344,2.049805181,579,522,1,112,'01_33_04.c3d',3,VE,L,H,4,diff,57
770,1430,660,0.563459898,1.055532854,573,469,1,1,'01_33_05.c3d',3,VE,L,H,5,diff,104
743,1882,1139,0.614849373,1.869862675,666,570,354,357,'01_33_01.c3d',4,VE,L,H,1,diff,96
779,1973,1194,0.487550428,0.952490628,722,483,1,1,'01_33_02.c3d',4,VE,L,H,2,diff,239
748,942,194,0.536061766,1.301378108,604,482,252,268,'01_33_03.c3d',4,VE,L,H,3,diff,122
1345,1696,351,0.484293956,0.965006651,1194,894,389,702,'01_33_04.c3d',4,VE,L,H,4,diff,300
763,1283,520,0.547445677,1.100008055,663,563,1,1,'01_33_05.c3d',4,VE,L,H,5,diff,100
771,876,105,0.789047089,3.106190452,484,528,1,395,'01_33_01.c3d',5,VE,L,H,1,diff,44
663,720,57,0.872899484,2.65845337,431,390,42,16,'01_33_02.c3d',5,VE,L,H,2,diff,41
543,593,50,0.781326713,3.158533423,392,450,1,91,'01_33_03.c3d',5,VE,L,H,3,diff,58
673,756,83,0.909133661,2.407854184,370,399,1,51,'01_33_04.c3d',5,VE,L,H,4,diff,29
719,895,176,0.829551123,2.622346557,514,427,1,240,'01_33_05.c3d',5,VE,L,H,5,diff,87
829,1794,965,0.50903774,1.731009488,698,1362,18,149,'01_33_01.c3d',6,VE,L,H,1,diff,664
815,1448,633,0.56187646,1.211243844,666,1156,1,625,'01_33_02.c3d',6,VE,L,H,2,diff,490
915,1337,422,0.473896885,1.236598325,630,488,1,1,'01_33_03.c3d',6,VE,L,H,3,diff,142
875,1556,681,0.546671734,1.05386989,678,1079,1,1,'01_33_04.c3d',6,VE,L,H,4,diff,401
834,1190,356,0.507393879,0.860187106,624,465,1,15,'01_33_05.c3d',6,VE,L,H,5,diff,159
1072,1457,385,0.406407641,1.004887377,762,729,1,108,'01_33_01.c3d',7,VE,L,H,1,diff,33
897,1356,459,0.489258256,1.034144867,779,685,1,1,'01_33_02.c3d',7,VE,L,H,2,diff,94
831,2875,2044,0.496934881,0.914834302,601,559,1,261,'01_33_03.c3d',7,VE,L,H,3,diff,42
714,1031,317,0.60623051,1.138802952,601,553,1,1,'01_33_04.c3d',7,VE,L,H,4,diff,48
749,1311,562,0.396959143,0.902221284,449,479,117,17,'01_33_05.c3d',7,VE,L,H,5,diff,30
1150,1916,766,0.349236516,1.064320346,887,677,132,1,'01_33_01.c3d',8,VE,L,H,1,diff,210
1019,1347,328,0.406043121,1.06088176,505,425,148,1,'01_33_02.c3d',8,VE,L,H,2,diff,80
1058,2105,1047,0.374812192,0.788274706,868,654,1,1,'01_33_03.c3d',8,VE,L,H,3,diff,214
997,1882,885,0.446122491,0.780973563,803,584,350,344,'01_33_04.c3d',8,VE,L,H,4,diff,219
928,1901,973,0.398603014,0.939986668,638,577,1,1,'01_33_05.c3d',8,VE,L,H,5,diff,61
1272,1342,70,0.291703101,1.195065343,543,413,177,243,'01_33_01.c3d',9,VE,L,H,1,diff,130
925,959,34,0.435045783,1.832001885,673,545,332,1,'01_33_02.c3d',9,VE,L,H,2,diff,128
1060,1434,374,0.424360033,1.446670238,606,543,288,29,'01_33_03.c3d',9,VE,L,H,3,diff,63
1155,2050,895,0.417488675,1.322075149,578,422,202,60,'01_33_04.c3d',9,VE,L,H,4,diff,156
781,939,158,0.562416746,1.724265286,597,467,1,39,'01_33_05.c3d',9,VE,L,H,5,diff,130
636,1125,489,0.609746451,3.532094856,637,458,296,297,'01_33_01.c3d',10,VE,L,H,1,diff,179
780,810,30,0.657745504,2.522434534,619,551,330,320,'01_33_02.c3d',10,VE,L,H,2,diff,68
852,912,60,0.383676551,1.50524332,423,406,17,97,'01_33_03.c3d',10,VE,L,H,3,diff,17
365,1372,1007,1.196185762,1.829971823,1,478,1,1,'01_33_04.c3d',10,VE,L,H,4,diff,477
903,1085,182,0.418805067,1.744546662,565,621,1,62,'01_33_05.c3d',10,VE,L,H,5,diff,56
1188,2123,935,0.366526854,0.643760781,992,669,8,1,'01_33_01.c3d',11,VE,L,H,1,diff,323
957,1485,528,0.375298541,0.914425569,805,480,1,1,'01_33_02.c3d',11,VE,L,H,2,diff,325
1180,1964,784,0.33246919,0.760843149,1045,640,1,1,'01_33_03.c3d',11,VE,L,H,3,diff,405
1181,1679,498,0.368636532,0.618046839,1015,711,1,1,'01_33_04.c3d',11,VE,L,H,4,diff,304
1311,1887,576,0.362538691,0.730344973,1045,767,537,54,'01_33_05.c3d',11,VE,L,H,5,diff,278
875,936,61,0.61510047,1.427353575,441,481,253,249,'01_33_01.c3d',12,VE,L,H,1,diff,40
826,889,63,0.474972446,1.509001958,537,458,1,276,'01_33_02.c3d',12,VE,L,H,2,diff,79
767,830,63,0.433810554,1.601887536,581,444,231,270,'01_33_03.c3d',12,VE,L,H,3,diff,137
674,953,279,0.527485925,1.343289834,512,498,1,1,'01_33_04.c3d',12,VE,L,H,4,diff,14
899,2451,1552,0.497149261,1.429072022,614,528,1,1,'01_33_05.c3d',12,VE,L,H,5,diff,86
1098,4877,3779,0.407370944,1.070473834,909,667,209,1,'01_33_01.c3d',13,VE,L,H,1,diff,242
948,1524,576,0.513964851,1.360595572,784,665,1,1,'01_33_02.c3d',13,VE,L,H,2,diff,119
846,1388,542,0.573124062,1.199084385,691,607,338,47,'01_33_03.c3d',13,VE,L,H,3,diff,84
927,1022,95,0.503765376,1.159250218,751,564,335,253,'01_33_04.c3d',13,VE,L,H,4,diff,187
807,978,171,0.577774901,1.568707912,657,535,273,298,'01_33_05.c3d',13,VE,L,H,5,diff,122
583,784,201,0.749077025,2.703606882,467,426,1,1,'01_33_01.c3d',14,VE,L,H,1,diff,41
1277,2196,919,0.621873947,1.172758585,830,469,1,1,'01_33_02.c3d',14,VE,L,H,2,diff,361
454,896,442,0.970756339,2.698525885,362,374,1,174,'01_33_03.c3d',14,VE,L,H,3,diff,12
752,968,216,0.631299145,2.394167208,475,510,1,314,'01_33_04.c3d',14,VE,L,H,4,diff,35
650,942,292,0.636738216,2.097348285,531,437,1,203,'01_33_05.c3d',14,VE,L,H,5,diff,94
769,1529,760,0.529759878,1.885412498,630,539,211,291,'01_33_01.c3d',15,VE,L,H,1,diff,91
746,1353,607,0.617435417,1.822418141,616,562,255,298,'01_33_02.c3d',15,VE,L,H,2,diff,54
848,1005,157,0.533002974,1.515630295,471,496,1,271,'01_33_03.c3d',15,VE,L,H,3,diff,25
821,1397,576,0.450787807,1.26621106,606,452,174,178,'01_33_04.c3d',15,VE,L,H,4,diff,154
682,1273,591,0.520556187,1.116972153,463,392,1,66,'01_33_05.c3d',15,VE,L,H,5,diff,71
783,826,43,0.463696399,1.74951806,627,446,1,86,'01_33_01.c3d',16,VE,L,H,1,diff,181
940,1727,787,0.767526702,1.666061088,722,472,240,244,'01_33_02.c3d',16,VE,L,H,2,diff,250
906,1294,388,0.354148945,1.615851928,799,426,266,241,'01_33_03.c3d',16,VE,L,H,3,diff,373
1046,1330,284,0.374973785,1.634832401,525,474,219,8,'01_33_04.c3d',16,VE,L,H,4,diff,51
1343,1443,100,0.227405536,1.235946475,708,498,1,1,'01_33_05.c3d',16,VE,L,H,5,diff,210
689,856,167,0.667927535,2.735313889,493,432,1,76,'01_33_01.c3d',17,VE,L,H,1,diff,61
674,1210,536,0.806701952,3.130656024,715,561,1,1,'01_33_02.c3d',17,VE,L,H,2,diff,154
631,875,244,0.763463099,3.722214972,546,537,1,326,'01_33_03.c3d',17,VE,L,H,3,diff,9
630,1147,517,0.76166133,1.912759157,514,482,284,277,'01_33_04.c3d',17,VE,L,H,4,diff,32
616,949,333,0.763368101,2.089185106,552,418,255,1,'01_33_05.c3d',17,VE,L,H,5,diff,134
985,1077,92,0.515420126,2.129464808,597,523,1,63,'01_33_01.c3d',18,VE,L,H,1,diff,74
775,1780,1005,0.514359765,2.277248064,698,548,1,1,'01_33_02.c3d',18,VE,L,H,2,diff,150
866,2338,1472,0.624511541,2.135472779,613,515,1,2,'01_33_03.c3d',18,VE,L,H,3,diff,98
873,2075,1202,0.662427657,1.854723481,647,529,1,309,'01_33_04.c3d',18,VE,L,H,4,diff,118
440,933,493,0.445010891,1.521488252,1,456,1,1,'01_33_05.c3d',18,VE,L,H,5,diff,455
853,904,51,0.513085147,1.676852565,779,482,1,253,'01_33_01.c3d',19,VE,L,H,1,diff,297
838,955,117,0.482314367,1.346148943,601,448,1,1,'01_33_02.c3d',19,VE,L,H,2,diff,153
752,891,139,0.51071666,1.743680827,516,489,204,219,'01_33_03.c3d',19,VE,L,H,3,diff,27
748,1294,546,0.566336918,1.3958491,561,486,118,44,'01_33_04.c3d',19,VE,L,H,4,diff,75
770,980,210,0.505049858,1.719261377,553,455,1,212,'01_33_05.c3d',19,VE,L,H,5,diff,98
804,917,113,0.570172924,1.745964073,642,472,245,272,'01_33_01.c3d',20,VE,L,H,1,diff,170
807,1608,801,0.594717186,1.595516564,814,539,302,1,'01_33_02.c3d',20,VE,L,H,2,diff,275
848,1281,433,0.588998941,1.297052682,723,536,316,315,'01_33_03.c3d',20,VE,L,H,3,diff,187
856,2664,1808,0.496613588,1.087681673,771,2235,306,28,'01_33_04.c3d',20,VE,L,H,4,diff,1464
1065,1323,258,0.455936195,1.07179549,888,621,334,306,'01_33_05.c3d',20,VE,L,H,5,diff,267
952,1803,851,0.497741439,1.107432676,797,659,336,342,'01_33_01.c3d',21,VE,L,H,1,diff,138
931,1542,611,0.625561341,0.877379348,806,627,412,4,'01_33_02.c3d',21,VE,L,H,2,diff,179
1024,1110,86,0.31241481,1.056023568,520,533,234,85,'01_33_03.c3d',21,VE,L,H,3,diff,13
878,1274,396,0.413237084,0.831592577,632,455,38,47,'01_33_04.c3d',21,VE,L,H,4,diff,177
835,1271,436,0.510931997,1.005025471,676,531,288,290,'01_33_05.c3d',21,VE,L,H,5,diff,145
1013,2008,995,0.568224322,1.080333627,876,1616,1,6,'01_33_01.c3d',22,VE,L,H,1,diff,740
804,1544,740,0.649536233,1.245500457,645,921,325,363,'01_33_02.c3d',22,VE,L,H,2,diff,276
851,1634,783,0.617089587,1.030116857,692,1300,314,386,'01_33_03.c3d',22,VE,L,H,3,diff,608
1125,1806,681,0.461730534,0.84920344,783,975,306,379,'01_33_04.c3d',22,VE,L,H,4,diff,192
1032,2005,973,0.525794895,1.094357921,821,1567,1,370,'01_33_05.c3d',22,VE,L,H,5,diff,746
963,1648,685,0.42281539,1.001394825,834,498,248,101,'01_33_01.c3d',23,VE,L,H,1,diff,336
1634,2719,1085,0.235576036,0.557612856,1545,2195,1,386,'01_33_02.c3d',23,VE,L,H,2,diff,650
1296,2225,929,0.305615479,0.677380176,1065,1819,1,1,'01_33_03.c3d',23,VE,L,H,3,diff,754
1195,3798,2603,0.36523245,0.636044463,1046,2382,332,381,'01_33_04.c3d',23,VE,L,H,4,diff,1336
1132,2461,1329,0.381833878,0.683410745,1003,1451,1,1,'01_33_05.c3d',23,VE,L,H,5,diff,448
675,886,211,0.603800346,1.816387214,575,425,1,250,'01_33_01.c3d',24,VE,L,H,1,diff,150
755,1008,253,0.555820219,1.474454763,563,447,1,248,'01_33_02.c3d',24,VE,L,H,2,diff,116
764,899,135,0.573529752,1.672496927,574,486,227,283,'01_33_03.c3d',24,VE,L,H,3,diff,88
781,1067,286,0.497719024,1.402097414,602,464,1,260,'01_33_04.c3d',24,VE,L,H,4,diff,138
916,1206,290,0.428879432,1.26364893,514,458,1,38,'01_33_05.c3d',24,VE,L,H,5,diff,56
1306,2301,995,0.305965033,0.489637446,982,1993,1,1,'01_33_01.c3d',25,VE,L,H,1,diff,1011
835,1043,208,0.434802946,1.242746948,562,466,203,255,'01_33_02.c3d',25,VE,L,H,2,diff,96
1329,2336,1007,0.379058193,0.699619438,1175,1905,419,292,'01_33_03.c3d',25,VE,L,H,3,diff,730
779,865,86,0.532756022,1.46421861,633,548,265,280,'01_33_04.c3d',25,VE,L,H,4,diff,85
944,1969,1025,0.354603128,0.865915362,588,570,220,240,'01_33_05.c3d',25,VE,L,H,5,diff,18
1248,1960,712,0.283597345,1.05802897,719,535,248,68,'01_33_01.c3d',26,VE,L,H,1,diff,184
1444,1769,325,0.29039524,0.755134467,974,821,261,36,'01_33_02.c3d',26,VE,L,H,2,diff,153
894,1030,136,0.310832764,1.343834158,697,435,1,1,'01_33_03.c3d',26,VE,L,H,3,diff,262
1424,1670,246,0.216864176,0.704192157,1038,654,1,11,'01_33_04.c3d',26,VE,L,H,4,diff,384
1148,1425,277,0.295422995,1.181123681,786,588,1,336,'01_33_05.c3d',26,VE,L,H,5,diff,198
1184,1207,23,0.549808594,1.551735182,815,690,1,399,'01_33_01.c3d',27,VE,L,H,1,diff,125
1109,1510,401,0.604169615,1.50190416,787,693,421,16,'01_33_02.c3d',27,VE,L,H,2,diff,94
1023,1586,563,0.64623003,1.060304842,875,810,1,1,'01_33_03.c3d',27,VE,L,H,3,diff,65
1188,1510,322,0.566829178,0.990639017,1005,931,1,1,'01_33_04.c3d',27,VE,L,H,4,diff,74
1035,1680,645,0.546043791,0.871432335,793,743,422,328,'01_33_05.c3d',27,VE,L,H,5,diff,50
1041,2381,1340,0.600916828,1.225732193,890,1560,1,553,'01_33_01.c3d',28,VE,L,H,1,diff,670
1001,1422,421,0.444750477,0.987598188,963,536,261,1,'01_33_02.c3d',28,VE,L,H,2,diff,427
1173,2942,1769,0.525273396,0.995842068,1001,1839,509,32,'01_33_03.c3d',28,VE,L,H,3,diff,838
952,1284,332,0.488428443,1.062446015,745,859,239,1,'01_33_04.c3d',28,VE,L,H,4,diff,114
919,1979,1060,0.558984693,0.834877283,819,1143,294,332,'01_33_05.c3d',28,VE,L,H,5,diff,324
755,1719,964,0.717374156,2.728714888,661,485,1,281,'01_33_01.c3d',29,VE,L,H,1,diff,176
968,1250,282,0.554231589,1.753995675,620,467,1,19,'01_33_02.c3d',29,VE,L,H,2,diff,153
1047,1173,126,0.472446342,1.724848937,807,667,1,1,'01_33_03.c3d',29,VE,L,H,3,diff,140
1498,1918,420,0.501965738,0.996146668,777,516,1,38,'01_33_04.c3d',29,VE,L,H,4,diff,261
875,897,22,0.399340732,1.691978394,816,478,261,1,'01_33_05.c3d',29,VE,L,H,5,diff,338
775,890,115,0.530336689,1.303154324,710,502,1,286,'01_33_01.c3d',30,VE,L,H,1,diff,208
1115,1282,167,0.355721078,0.908969813,768,478,1,44,'01_33_02.c3d',30,VE,L,H,2,diff,290
1025,1348,323,0.374436783,0.769403123,610,904,1,78,'01_33_03.c3d',30,VE,L,H,3,diff,294
976,1290,314,0.401334666,0.884775706,782,492,1,252,'01_33_04.c3d',30,VE,L,H,4,diff,290
694,1091,397,0.457165867,0.953997543,392,283,1,59,'01_33_05.c3d',30,VE,L,H,5,diff,109
935,1547,612,0.747156451,1.71363795,700,647,1,396,'01_33_01.c3d',31,VE,L,H,1,diff,53
764,1723,959,0.768661246,1.784578546,559,488,269,286,'01_33_02.c3d',31,VE,L,H,2,diff,71
883,1241,358,0.610780423,1.342431953,587,487,281,289,'01_33_03.c3d',31,VE,L,H,3,diff,100
862,1216,354,0.798114393,1.895997394,577,505,307,315,'01_33_04.c3d',31,VE,L,H,4,diff,72
755,1458,703,0.882292378,1.525905259,604,557,305,301,'01_33_05.c3d',31,VE,L,H,5,diff,47
838,1172,334,0.491017587,1.317592769,648,528,267,1,'01_33_01.c3d',32,VE,L,H,1,diff,120
797,1369,572,0.514147919,1.328794865,643,427,239,47,'01_33_02.c3d',32,VE,L,H,2,diff,216
1103,1220,117,0.409154274,1.017030028,827,663,1,336,'01_33_03.c3d',32,VE,L,H,3,diff,164
873,1538,665,0.528224541,0.998325408,680,562,1,30,'01_33_04.c3d',32,VE,L,H,4,diff,118
1034,1051,17,0.438515716,1.000179063,758,941,326,315,'01_33_05.c3d',32,VE,L,H,5,diff,183
961,1375,414,0.558593517,0.993546102,807,603,1,310,'01_33_01.c3d',33,VE,L,H,1,diff,204
1089,1679,590,0.555534811,0.920908987,969,657,414,34,'01_33_02.c3d',33,VE,L,H,2,diff,312
1234,2646,1412,0.524717833,0.924628732,1078,961,1,10,'01_33_03.c3d',33,VE,L,H,3,diff,117
1104,1979,875,0.449782806,0.826943071,873,554,301,298,'01_33_04.c3d',33,VE,L,H,4,diff,319
841,1429,588,0.463686703,0.796008472,716,551,125,25,'01_33_05.c3d',33,VE,L,H,5,diff,165
706,1275,569,0.550922774,1.297463976,600,492,292,294,'01_33_01.c3d',34,VE,L,H,1,diff,108
732,1000,268,0.599655526,1.278095887,632,477,294,1,'01_33_02.c3d',34,VE,L,H,2,diff,155
856,1284,428,0.465157383,1.125400138,619,486,278,269,'01_33_03.c3d',34,VE,L,H,3,diff,133
743,920,177,0.474706909,1.284997451,595,443,248,239,'01_33_04.c3d',34,VE,L,H,4,diff,152
876,975,99,0.423867472,1.292682818,552,397,233,1,'01_33_05.c3d',34,VE,L,H,5,diff,155
1047,1560,513,0.518122551,1.206517896,795,624,1,71,'01_33_01.c3d',35,VE,L,H,1,diff,171
837,1002,165,0.616086257,1.753219788,545,451,110,107,'01_33_02.c3d',35,VE,L,H,2,diff,94
780,1315,535,0.54594642,1.55646748,545,442,1,29,'01_33_03.c3d',35,VE,L,H,3,diff,103
904,1205,301,0.52824969,1.204497335,564,454,210,236,'01_33_04.c3d',35,VE,L,H,4,diff,110
857,1204,347,0.511346482,1.337380823,485,744,22,34,'01_33_05.c3d',35,VE,L,H,5,diff,259
803,1286,483,0.839346383,0.756137418,1078,609,1,13,'01_34_01.c3d',1,VE,R,E,1,diff,469
479,1119,640,0.911230783,0.948180801,694,382,96,1,'01_34_02.c3d',1,VE,R,E,2,diff,312
739,2037,1298,0.818504846,1.51500269,1000,670,462,1,'01_34_03.c3d',1,VE,R,E,3,diff,330
724,1532,808,0.704989823,1.772867352,766,473,1,247,'01_34_04.c3d',1,VE,R,E,4,diff,293
752,969,217,1.199360548,0.741037593,778,650,337,139,'01_34_05.c3d',1,VE,R,E,5,diff,128
1193,3011,1818,0.907241635,0.991060096,918,587,363,1,'01_34_01.c3d',2,VE,R,E,1,diff,331
773,1390,617,0.917428462,0.981675944,949,578,350,109,'01_34_02.c3d',2,VE,R,E,2,diff,371
789,1090,301,0.925708241,0.751675721,869,484,1,59,'01_34_03.c3d',2,VE,R,E,3,diff,385
591,1361,770,0.909916929,1.08342459,722,506,1,23,'01_34_04.c3d',2,VE,R,E,4,diff,216
1042,1068,26,0.930928544,0.834810308,718,471,285,1,'01_34_05.c3d',2,VE,R,E,5,diff,247
474,936,462,1.501365272,2.102081119,631,438,1,285,'01_34_01.c3d',3,VE,R,E,1,diff,193
678,851,173,1.314391554,1.303111533,711,481,311,1,'01_34_02.c3d',3,VE,R,E,2,diff,230
568,929,361,1.0505258,1.518021964,663,506,1,1,'01_34_03.c3d',3,VE,R,E,3,diff,157
626,1042,416,0.88708511,1.425568272,794,569,268,43,'01_34_04.c3d',3,VE,R,E,4,diff,225
912,1456,544,1.012557846,0.969275056,768,489,308,304,'01_34_05.c3d',3,VE,R,E,5,diff,279
613,1602,989,1.288587021,1.397923977,728,564,362,1,'01_34_01.c3d',4,VE,R,E,1,diff,164
899,1341,442,1.255792257,1.30554612,663,493,1,327,'01_34_02.c3d',4,VE,R,E,2,diff,170
634,840,206,1.034288636,1.048040606,666,455,1,37,'01_34_03.c3d',4,VE,R,E,3,diff,211
750,1097,347,0.84878531,0.729202162,670,476,294,5,'01_34_04.c3d',4,VE,R,E,4,diff,194
631,1807,1176,0.919207898,0.824864549,689,428,199,44,'01_34_05.c3d',4,VE,R,E,5,diff,261
561,860,299,1.829671155,1.619867166,644,518,365,99,'01_34_01.c3d',5,VE,R,E,1,diff,126
450,656,206,2.204625613,2.332136884,496,450,277,224,'01_34_02.c3d',5,VE,R,E,2,diff,46
454,822,368,1.460593242,1.469722721,564,388,248,54,'01_34_03.c3d',5,VE,R,E,3,diff,176
604,751,147,1.476420456,1.827033182,610,427,272,277,'01_34_04.c3d',5,VE,R,E,4,diff,183
279,697,418,1.803042283,2.200203813,406,286,84,8,'01_34_05.c3d',5,VE,R,E,5,diff,120
625,1467,842,1.252044734,0.913552584,1252,492,284,1,'01_34_01.c3d',6,VE,R,E,1,diff,760
637,1013,376,0.880937571,1.005701654,924,469,304,1,'01_34_02.c3d',6,VE,R,E,2,diff,455
632,1609,977,1.270898423,1.383757864,1460,599,926,1,'01_34_03.c3d',6,VE,R,E,3,diff,861
602,1028,426,0.961002647,1.126466207,860,470,252,5,'01_34_04.c3d',6,VE,R,E,4,diff,390
1195,1631,436,0.530894776,0.958747563,1148,470,50,1,'01_34_05.c3d',6,VE,R,E,5,diff,678
712,954,242,0.967204537,0.765606631,658,472,309,232,'01_34_01.c3d',7,VE,R,E,1,diff,186
498,1003,505,0.814204977,0.980382737,663,413,43,174,'01_34_02.c3d',7,VE,R,E,2,diff,250
517,772,255,1.3179618,0.968806341,583,438,1,1,'01_34_03.c3d',7,VE,R,E,3,diff,145
602,804,202,1.173018827,0.901932484,665,459,176,164,'01_34_04.c3d',7,VE,R,E,4,diff,206
623,1617,994,1.200927387,1.013808539,588,403,169,174,'01_34_05.c3d',7,VE,R,E,5,diff,185
811,1432,621,0.89137646,0.842177435,735,477,279,281,'01_34_01.c3d',8,VE,R,E,1,diff,258
567,2224,1657,0.946390145,1.055974637,766,452,237,245,'01_34_02.c3d',8,VE,R,E,2,diff,314
817,1088,271,1.059291733,1.106688962,665,481,261,1,'01_34_03.c3d',8,VE,R,E,3,diff,184
637,1010,373,1.024365931,1.018036471,620,517,1,1,'01_34_04.c3d',8,VE,R,E,4,diff,103
728,1515,787,0.778706328,0.816151812,681,471,235,254,'01_34_05.c3d',8,VE,R,E,5,diff,210
711,1735,1024,0.785830594,1.379521934,607,458,253,161,'01_34_01.c3d',9,VE,R,E,1,diff,149
802,1649,847,0.653096715,0.973562597,585,455,267,137,'01_34_02.c3d',9,VE,R,E,2,diff,130
656,1716,1060,0.942276793,1.08575907,564,410,257,1,'01_34_03.c3d',9,VE,R,E,3,diff,154
701,1559,858,0.895342189,0.939712417,685,489,1,85,'01_34_04.c3d',9,VE,R,E,4,diff,196
941,2128,1187,0.72701299,0.703705268,1644,443,290,254,'01_34_05.c3d',9,VE,R,E,5,diff,1201
484,1232,748,1.615283602,1.505904164,488,385,1,1,'01_34_01.c3d',10,VE,R,E,1,diff,103
542,878,336,1.306189007,1.132823998,431,409,230,227,'01_34_02.c3d',10,VE,R,E,2,diff,22
688,1493,805,0.787487044,1.493243052,590,469,222,270,'01_34_03.c3d',10,VE,R,E,3,diff,121
493,1794,1301,1.333023829,1.154813247,478,456,27,1,'01_34_04.c3d',10,VE,R,E,4,diff,22
643,1485,842,1.056599986,1.069086147,590,391,270,241,'01_34_05.c3d',10,VE,R,E,5,diff,199
694,1077,383,0.996423102,0.84468941,687,551,313,1,'01_34_01.c3d',11,VE,R,E,1,diff,136
924,1483,559,0.847923902,0.758307037,1023,759,1,87,'01_34_02.c3d',11,VE,R,E,2,diff,264
943,1476,533,0.63500601,0.651930989,1264,776,346,1,'01_34_03.c3d',11,VE,R,E,3,diff,488
1100,1607,507,0.56345023,0.553950701,1031,627,1,1,'01_34_04.c3d',11,VE,R,E,4,diff,404
1616,2511,895,0.338393989,0.254034737,1484,1228,347,1,'01_34_05.c3d',11,VE,R,E,5,diff,256
607,1186,579,1.126112605,1.061292459,665,495,298,1,'01_34_01.c3d',12,VE,R,E,1,diff,170
889,909,20,1.018529275,0.973553247,485,455,310,4,'01_34_02.c3d',12,VE,R,E,2,diff,30
603,918,315,0.942197342,1.031544645,677,474,281,276,'01_34_03.c3d',12,VE,R,E,3,diff,203
635,715,80,1.661530949,1.095370241,639,436,305,284,'01_34_04.c3d',12,VE,R,E,4,diff,203
928,951,23,0.910746981,0.694818983,752,428,113,1,'01_34_05.c3d',12,VE,R,E,5,diff,324
676,1098,422,1.250959791,0.934465605,699,565,1,1,'01_34_01.c3d',13,VE,R,E,1,diff,134
622,1668,1046,1.160548387,1.282681997,664,526,319,1,'01_34_02.c3d',13,VE,R,E,2,diff,138
566,1266,700,0.973772894,1.32384921,787,493,102,112,'01_34_03.c3d',13,VE,R,E,3,diff,294
740,1057,317,1.180985078,0.938305327,724,555,330,55,'01_34_04.c3d',13,VE,R,E,4,diff,169
589,1337,748,1.316018086,1.257370936,623,504,298,96,'01_34_05.c3d',13,VE,R,E,5,diff,119
456,908,452,1.499088687,1.994133827,568,424,240,257,'01_34_01.c3d',14,VE,R,E,1,diff,144
437,792,355,1.325734087,2.079124726,404,408,69,47,'01_34_02.c3d',14,VE,R,E,2,diff,4
448,830,382,1.38526702,1.64675343,506,405,174,168,'01_34_03.c3d',14,VE,R,E,3,diff,101
555,1025,470,1.063861954,1.056409354,517,415,1,1,'01_34_04.c3d',14,VE,R,E,4,diff,102
810,883,73,1.489527502,0.795095632,660,438,208,167,'01_34_05.c3d',14,VE,R,E,5,diff,222
606,857,251,1.178165855,1.229761417,546,435,232,97,'01_34_01.c3d',15,VE,R,E,1,diff,111
738,1029,291,1.068149534,0.994474779,660,492,293,1,'01_34_02.c3d',15,VE,R,E,2,diff,168
575,1047,472,0.756002537,0.97397306,596,379,111,19,'01_34_03.c3d',15,VE,R,E,3,diff,217
520,1022,502,0.836386812,1.046978939,671,371,212,114,'01_34_04.c3d',15,VE,R,E,4,diff,300
1078,1226,148,0.979318032,0.542976999,954,804,1,1,'01_34_05.c3d',15,VE,R,E,5,diff,150
772,1252,480,0.939341164,1.017058009,922,528,30,1,'01_34_01.c3d',16,VE,R,E,1,diff,394
764,1012,248,0.999582986,1.026940592,774,375,1,190,'01_34_02.c3d',16,VE,R,E,2,diff,399
586,1961,1375,0.830270487,1.341157782,767,439,1,1,'01_34_03.c3d',16,VE,R,E,3,diff,328
342,743,401,1.209934285,1.238680995,558,272,115,1,'01_34_04.c3d',16,VE,R,E,4,diff,286
942,1011,69,1.049619016,1.003644454,734,468,1,16,'01_34_05.c3d',16,VE,R,E,5,diff,266
592,609,17,2.399584503,1.774207809,505,415,279,276,'01_34_01.c3d',17,VE,R,E,1,diff,90
428,988,560,1.792724382,2.242453506,522,402,258,1,'01_34_02.c3d',17,VE,R,E,2,diff,120
566,630,64,1.990187444,1.822475445,545,381,256,251,'01_34_03.c3d',17,VE,R,E,3,diff,164
426,736,310,1.807511528,1.87652712,509,375,239,251,'01_34_04.c3d',17,VE,R,E,4,diff,134
418,694,276,1.824630043,1.978381029,466,382,1,254,'01_34_05.c3d',17,VE,R,E,5,diff,84
804,954,150,1.206249909,1.382185968,737,608,1,1,'01_34_01.c3d',18,VE,R,E,1,diff,129
662,1016,354,1.223089265,1.568580849,677,519,37,6,'01_34_02.c3d',18,VE,R,E,2,diff,158
516,1003,487,1.510812888,1.716350549,701,485,1,1,'01_34_03.c3d',18,VE,R,E,3,diff,216
484,1376,892,1.092059083,1.411624945,590,428,1,211,'01_34_04.c3d',18,VE,R,E,4,diff,162
155,1086,931,1.199007635,1.201852294,1,18,1,1,'01_34_05.c3d',18,VE,R,E,5,diff,17
891,1337,446,0.638031997,0.897887173,842,478,56,1,'01_34_01.c3d',19,VE,R,E,1,diff,364
727,1346,619,0.821547664,0.848520024,774,488,262,257,'01_34_02.c3d',19,VE,R,E,2,diff,286
605,971,366,1.04364679,1.157121902,679,463,316,55,'01_34_03.c3d',19,VE,R,E,3,diff,216
509,911,402,1.065183379,1.26402096,641,441,1,86,'01_34_04.c3d',19,VE,R,E,4,diff,200
809,982,173,1.070921763,1.086223868,669,459,258,31,'01_34_05.c3d',19,VE,R,E,5,diff,210
698,1009,311,1.090127811,1.242476017,725,539,373,112,'01_34_01.c3d',20,VE,R,E,1,diff,186
804,1120,316,1.103837812,1.353605496,824,611,423,365,'01_34_02.c3d',20,VE,R,E,2,diff,213
869,1032,163,0.97119364,1.00323996,771,480,1,55,'01_34_03.c3d',20,VE,R,E,3,diff,291
612,1004,392,0.96953543,1.234471586,782,524,298,262,'01_34_04.c3d',20,VE,R,E,4,diff,258
608,1421,813,0.86196982,1.561895504,679,426,257,1,'01_34_05.c3d',20,VE,R,E,5,diff,253
988,1248,260,0.95416435,0.811753816,1076,597,1,1,'01_34_01.c3d',21,VE,R,E,1,diff,479
1054,1363,309,0.966629156,0.900492482,920,597,403,391,'01_34_02.c3d',21,VE,R,E,2,diff,323
1017,1184,167,0.747451745,0.681287654,973,576,340,321,'01_34_03.c3d',21,VE,R,E,3,diff,397
979,1162,183,0.803076313,0.772986134,834,481,309,294,'01_34_04.c3d',21,VE,R,E,4,diff,353
769,1326,557,0.696914044,0.681321994,787,648,1,1,'01_34_05.c3d',21,VE,R,E,5,diff,139
840,1964,1124,0.665981536,1.320839813,1754,695,442,464,'01_34_01.c3d',22,VE,R,E,1,diff,1059
1054,1281,227,0.924855912,1.042824094,1031,783,1,1,'01_34_02.c3d',22,VE,R,E,2,diff,248
1279,1863,584,0.536286755,0.702481894,1614,725,1,16,'01_34_03.c3d',22,VE,R,E,3,diff,889
938,1452,514,0.775201396,1.089128172,1302,595,311,326,'01_34_04.c3d',22,VE,R,E,4,diff,707
774,1674,900,0.547419304,0.950521533,1361,599,305,334,'01_34_05.c3d',22,VE,R,E,5,diff,762
1222,3422,2200,0.444643895,0.846855314,1058,602,331,12,'01_34_01.c3d',23,VE,R,E,1,diff,456
1400,1511,111,0.54361227,0.779891305,927,515,291,96,'01_34_02.c3d',23,VE,R,E,2,diff,412
1587,1857,270,0.45962975,0.509792798,1229,489,296,292,'01_34_03.c3d',23,VE,R,E,3,diff,740
1123,1931,808,0.40369678,0.436794265,1123,594,269,52,'01_34_04.c3d',23,VE,R,E,4,diff,529
1487,2047,560,0.377981085,0.400563516,1248,800,310,9,'01_34_05.c3d',23,VE,R,E,5,diff,448
834,974,140,1.026900836,1.166341384,884,483,301,1,'01_34_01.c3d',24,VE,R,E,1,diff,401
678,1060,382,1.246192503,1.12016129,676,518,328,1,'01_34_02.c3d',24,VE,R,E,2,diff,158
591,1454,863,1.209437072,1.270532153,580,430,250,81,'01_34_03.c3d',24,VE,R,E,3,diff,150
963,1060,97,1.081823419,0.990040821,729,459,238,255,'01_34_04.c3d',24,VE,R,E,4,diff,270
714,814,100,1.063704744,0.631660915,567,257,1,1,'01_34_05.c3d',24,VE,R,E,5,diff,310
1594,2407,813,0.595835876,0.807141516,1404,1202,533,542,'01_34_01.c3d',25,VE,R,E,1,diff,202
511,859,348,1.401983061,1.749197248,545,464,329,316,'01_34_02.c3d',25,VE,R,E,2,diff,81
734,1072,338,1.0034906,1.130624635,637,511,270,8,'01_34_03.c3d',25,VE,R,E,3,diff,126
841,1184,343,0.965836268,0.883258901,683,500,237,21,'01_34_04.c3d',25,VE,R,E,4,diff,183
1136,1181,45,0.892611751,0.64148029,721,531,240,1,'01_34_05.c3d',25,VE,R,E,5,diff,190
1031,1264,233,0.648467731,0.565798853,1104,464,245,1,'01_34_01.c3d',26,VE,R,E,1,diff,640
1073,1898,825,0.56107911,0.696178595,902,485,265,247,'01_34_02.c3d',26,VE,R,E,2,diff,417
559,2229,1670,0.637984757,0.993019727,1080,435,271,235,'01_34_03.c3d',26,VE,R,E,3,diff,645
1596,1784,188,0.524704348,0.316795957,1215,635,323,18,'01_34_04.c3d',26,VE,R,E,4,diff,580
926,1157,231,0.665325898,0.732195553,892,442,245,88,'01_34_05.c3d',26,VE,R,E,5,diff,450
838,1575,737,0.886112525,0.939590854,964,721,435,415,'01_34_01.c3d',27,VE,R,E,1,diff,243
1000,1223,223,0.811674989,0.649312475,720,516,310,42,'01_34_02.c3d',27,VE,R,E,2,diff,204
1275,1571,296,0.807338888,0.632695554,1193,720,462,55,'01_34_03.c3d',27,VE,R,E,3,diff,473
1225,1366,141,0.861383018,0.721436352,792,701,372,1,'01_34_04.c3d',27,VE,R,E,4,diff,91
1321,1471,150,0.917533572,0.741417449,973,862,1,79,'01_34_05.c3d',27,VE,R,E,5,diff,111
1145,2831,1686,0.696574531,0.755528681,2274,555,1,374,'01_34_01.c3d',28,VE,R,E,1,diff,1719
1311,2319,1008,0.51016722,0.645563106,1850,740,1,383,'01_34_02.c3d',28,VE,R,E,2,diff,1110
625,1196,571,0.869634448,1.175208389,871,525,1,1,'01_34_03.c3d',28,VE,R,E,3,diff,346
933,1411,478,0.789983089,0.797769612,859,783,259,1,'01_34_04.c3d',28,VE,R,E,4,diff,76
979,1274,295,0.768087771,0.645922418,980,584,1,313,'01_34_05.c3d',28,VE,R,E,5,diff,396
556,1372,816,1.487019483,1.305900243,610,446,288,1,'01_34_01.c3d',29,VE,R,E,1,diff,164
429,951,522,1.004204652,1.218093244,601,365,1,133,'01_34_02.c3d',29,VE,R,E,2,diff,236
1244,1409,165,0.703614431,0.837040683,895,549,349,330,'01_34_03.c3d',29,VE,R,E,3,diff,346
588,1127,539,0.825161493,1.166364016,763,478,1,269,'01_34_04.c3d',29,VE,R,E,4,diff,285
1074,1321,247,0.77429729,0.82972902,737,443,1,1,'01_34_05.c3d',29,VE,R,E,5,diff,294
584,950,366,0.877909647,0.841860792,737,389,131,7,'01_34_01.c3d',30,VE,R,E,1,diff,348
993,1052,59,0.851582739,0.667600155,863,385,232,1,'01_34_02.c3d',30,VE,R,E,2,diff,478
720,1176,456,0.80240667,0.796478277,933,488,1,1,'01_34_03.c3d',30,VE,R,E,3,diff,445
857,1245,388,0.692277842,0.647946056,792,472,1,263,'01_34_04.c3d',30,VE,R,E,4,diff,320
832,968,136,0.846965594,0.701759491,776,356,1,112,'01_34_05.c3d',30,VE,R,E,5,diff,420
710,1139,429,1.239767808,1.648648716,797,546,350,347,'01_34_01.c3d',31,VE,R,E,1,diff,251
520,1183,663,1.580206218,2.0105849,651,471,310,306,'01_34_02.c3d',31,VE,R,E,2,diff,180
575,1465,890,1.66362189,1.723885116,717,468,292,291,'01_34_03.c3d',31,VE,R,E,3,diff,249
566,924,358,1.345634417,1.54232942,635,447,278,265,'01_34_04.c3d',31,VE,R,E,4,diff,188
626,861,235,1.583173821,1.45367623,698,455,264,232,'01_34_05.c3d',31,VE,R,E,5,diff,243
1256,1420,164,1.204930169,0.715655125,779,511,366,1,'01_34_01.c3d',32,VE,R,E,1,diff,268
1159,1892,733,0.925277252,0.595795838,739,483,334,1,'01_34_02.c3d',32,VE,R,E,2,diff,256
590,1059,469,1.20658736,1.078700761,723,464,268,20,'01_34_03.c3d',32,VE,R,E,3,diff,259
682,1040,358,1.187353504,0.927268413,688,521,286,288,'01_34_04.c3d',32,VE,R,E,4,diff,167
971,1386,415,1.15759787,0.650284308,872,513,288,274,'01_34_05.c3d',32,VE,R,E,5,diff,359
958,1607,649,0.670625476,0.637201251,1240,693,427,32,'01_34_01.c3d',33,VE,R,E,1,diff,547
1212,1392,180,0.979062095,0.602828669,1069,742,463,355,'01_34_02.c3d',33,VE,R,E,2,diff,327
945,1146,201,0.996381416,0.810624075,916,598,364,341,'01_34_03.c3d',33,VE,R,E,3,diff,318
1063,1097,34,1.153209061,0.718173724,825,562,328,1,'01_34_04.c3d',33,VE,R,E,4,diff,263
805,1178,373,1.170340407,1.303674923,946,646,433,1,'01_34_05.c3d',33,VE,R,E,5,diff,300
947,1436,489,1.260135245,1.090579276,952,862,599,575,'01_34_01.c3d',34,VE,R,E,1,diff,90
514,919,405,1.265253769,1.269036853,653,424,1,281,'01_34_02.c3d',34,VE,R,E,2,diff,229
536,1624,1088,1.210867523,1.181848205,618,402,286,255,'01_34_03.c3d',34,VE,R,E,3,diff,216
863,1761,898,0.888634907,0.843555478,908,674,398,1,'01_34_04.c3d',34,VE,R,E,4,diff,234
886,1136,250,0.674533845,0.673428502,730,406,250,250,'01_34_05.c3d',34,VE,R,E,5,diff,324
585,872,287,1.332491473,1.169173796,614,425,248,233,'01_34_01.c3d',35,VE,R,E,1,diff,189
555,1139,584,1.240101976,1.178005048,642,399,232,224,'01_34_02.c3d',35,VE,R,E,2,diff,243
570,1024,454,1.350767391,1.208434223,672,439,250,62,'01_34_03.c3d',35,VE,R,E,3,diff,233
562,854,292,1.261119892,1.07664937,616,368,1,1,'01_34_04.c3d',35,VE,R,E,4,diff,248
677,1088,411,1.037963795,1.085779661,681,534,280,1,'01_34_05.c3d',35,VE,R,E,5,diff,147
766,1664,898,0.587531173,0.972594152,1160,588,363,366,'01_35_01.c3d',1,VE,R,M,1,diff,572
578,1574,996,0.952461122,1.149022565,817,478,1,2,'01_35_02.c3d',1,VE,R,M,2,diff,339
655,1137,482,0.777740339,0.968928024,911,549,242,259,'01_35_03.c3d',1,VE,R,M,3,diff,362
751,1424,673,0.93174984,0.968133765,825,572,368,19,'01_35_04.c3d',1,VE,R,M,4,diff,253
525,1108,583,1.000857569,0.772920126,716,292,1,14,'01_35_05.c3d',1,VE,R,M,5,diff,424
1224,2109,885,0.695217275,1.073707968,1069,573,1,1,'01_35_01.c3d',2,VE,R,M,1,diff,496
827,2177,1350,0.698859214,1.194569271,1196,670,449,27,'01_35_02.c3d',2,VE,R,M,2,diff,526
1323,1353,30,0.588700361,0.910837135,1130,427,1,1,'01_35_03.c3d',2,VE,R,M,3,diff,703
1044,1276,232,0.695834318,1.033075455,913,462,1,1,'01_35_04.c3d',2,VE,R,M,4,diff,451
1059,1380,321,0.978289641,1.17627606,810,480,1,1,'01_35_05.c3d',2,VE,R,M,5,diff,330
657,776,119,1.391245292,0.942993756,614,367,1,42,'01_35_01.c3d',3,VE,R,M,1,diff,247
563,984,421,1.170584386,1.597405551,703,469,1,295,'01_35_02.c3d',3,VE,R,M,2,diff,234
1052,1113,61,0.979988267,0.959082733,698,429,1,168,'01_35_03.c3d',3,VE,R,M,3,diff,269
553,1313,760,1.033691743,1.43838951,627,495,1,1,'01_35_04.c3d',3,VE,R,M,4,diff,132
413,896,483,1.10812857,1.475094206,546,373,1,147,'01_35_05.c3d',3,VE,R,M,5,diff,173
887,1254,367,0.990899203,0.861976214,727,549,1,1,'01_35_01.c3d',4,VE,R,M,1,diff,178
748,977,229,0.970649996,1.637050272,653,510,1,1,'01_35_02.c3d',4,VE,R,M,2,diff,143
882,884,2,1.080189725,1.233575195,713,480,1,9,'01_35_03.c3d',4,VE,R,M,3,diff,233
615,949,334,0.840166061,0.858713189,706,428,233,1,'01_35_04.c3d',4,VE,R,M,4,diff,278
1024,1285,261,0.628266491,0.696778295,738,590,1,1,'01_35_05.c3d',4,VE,R,M,5,diff,148
665,1160,495,1.939581202,1.483006457,934,607,513,424,'01_35_01.c3d',5,VE,R,M,1,diff,327
413,833,420,1.880853536,2.633317365,506,396,277,256,'01_35_02.c3d',5,VE,R,M,2,diff,110
521,789,268,1.632229904,1.32726114,587,491,1,1,'01_35_03.c3d',5,VE,R,M,3,diff,96
421,833,412,1.556262173,1.896445977,536,392,239,224,'01_35_04.c3d',5,VE,R,M,4,diff,144
236,601,365,1.484024615,1.076653188,394,278,1,1,'01_35_05.c3d',5,VE,R,M,5,diff,116
608,1533,925,0.812292888,0.918059607,1347,483,1,289,'01_35_01.c3d',6,VE,R,M,1,diff,864
687,1465,778,1.120258343,0.987202778,1350,553,297,1,'01_35_02.c3d',6,VE,R,M,2,diff,797
887,1771,884,0.953509938,0.966570244,1408,522,1,1,'01_35_03.c3d',6,VE,R,M,3,diff,886
628,1354,726,1.019500359,1.331530552,829,452,1,274,'01_35_04.c3d',6,VE,R,M,4,diff,377
946,1478,532,1.064999312,0.84709546,1277,766,11,1,'01_35_05.c3d',6,VE,R,M,5,diff,511
671,1239,568,0.66304515,0.819112833,997,558,1,1,'01_35_01.c3d',7,VE,R,M,1,diff,439
810,1244,434,0.702884278,0.571113738,747,521,338,1,'01_35_02.c3d',7,VE,R,M,2,diff,226
598,1058,460,0.941172611,0.833671384,717,476,271,57,'01_35_03.c3d',7,VE,R,M,3,diff,241
627,1104,477,0.925588377,1.048755019,711,518,293,1,'01_35_04.c3d',7,VE,R,M,4,diff,193
443,878,435,1.009162503,0.89411972,629,405,106,1,'01_35_05.c3d',7,VE,R,M,5,diff,224
657,1618,961,0.748352048,0.809502127,854,593,282,264,'01_35_01.c3d',8,VE,R,M,1,diff,261
539,1146,607,0.756581946,1.104096376,668,427,220,227,'01_35_02.c3d',8,VE,R,M,2,diff,241
1112,1685,573,0.515908379,0.646364599,839,519,52,1,'01_35_03.c3d',8,VE,R,M,3,diff,320
945,1460,515,0.68514451,0.797245947,1102,532,343,327,'01_35_04.c3d',8,VE,R,M,4,diff,570
1113,1248,135,0.715723115,0.760467391,808,519,287,302,'01_35_05.c3d',8,VE,R,M,5,diff,289
945,2021,1076,0.605611985,0.943280533,1642,613,1,1,'01_35_01.c3d',9,VE,R,M,1,diff,1029
738,1397,659,0.620292008,0.933373599,507,390,1,44,'01_35_02.c3d',9,VE,R,M,2,diff,117
703,1774,1071,0.517774135,0.928433669,637,522,1,46,'01_35_03.c3d',9,VE,R,M,3,diff,115
729,1730,1001,0.629112412,0.968594684,634,474,1,283,'01_35_04.c3d',9,VE,R,M,4,diff,160
654,1930,1276,0.828714525,0.942540484,1448,465,298,257,'01_35_05.c3d',9,VE,R,M,5,diff,983
855,859,4,1.691891443,1.574205573,674,520,365,381,'01_35_01.c3d',10,VE,R,M,1,diff,154
775,815,40,1.328173016,1.288564355,614,411,251,245,'01_35_02.c3d',10,VE,R,M,2,diff,203
567,1002,435,0.916465685,1.308736636,668,476,236,248,'01_35_03.c3d',10,VE,R,M,3,diff,192
587,1339,752,0.834420434,1.202730629,701,442,265,1,'01_35_04.c3d',10,VE,R,M,4,diff,259
484,1510,1026,0.906975405,0.874337599,585,1,1,1,'01_35_05.c3d',10,VE,R,M,5,diff,584
1163,1211,48,0.787729845,0.730292658,1016,581,374,1,'01_35_01.c3d',11,VE,R,M,1,diff,435
854,1318,464,0.777208564,0.629454097,1031,682,435,1,'01_35_02.c3d',11,VE,R,M,2,diff,349
1213,1756,543,0.442250694,0.505485502,1548,695,13,103,'01_35_03.c3d',11,VE,R,M,3,diff,853
1045,1169,124,0.859539664,0.74329351,1032,613,1,358,'01_35_04.c3d',11,VE,R,M,4,diff,419
994,1695,701,0.567603183,0.608991125,933,549,1,170,'01_35_05.c3d',11,VE,R,M,5,diff,384
586,884,298,1.173448907,1.134580234,581,498,295,298,'01_35_01.c3d',12,VE,R,M,1,diff,83
566,994,428,1.019449308,1.374115891,615,518,332,327,'01_35_02.c3d',12,VE,R,M,2,diff,97
798,996,198,0.865695138,0.916386309,592,429,262,156,'01_35_03.c3d',12,VE,R,M,3,diff,163
946,962,16,0.916982082,0.920699649,695,437,274,1,'01_35_04.c3d',12,VE,R,M,4,diff,258
614,924,310,0.960534778,0.886012909,626,424,243,1,'01_35_05.c3d',12,VE,R,M,5,diff,202
779,1134,355,1.095794537,0.680224015,767,656,1,1,'01_35_01.c3d',13,VE,R,M,1,diff,111
529,1533,1004,1.180302348,1.300984108,679,435,200,48,'01_35_02.c3d',13,VE,R,M,2,diff,244
644,993,349,1.033164175,1.075073477,679,497,270,1,'01_35_03.c3d',13,VE,R,M,3,diff,182
549,1047,498,0.977013593,1.612277147,671,512,257,282,'01_35_04.c3d',13,VE,R,M,4,diff,159
567,997,430,0.92880139,1.123028615,736,434,1,231,'01_35_05.c3d',13,VE,R,M,5,diff,302
423,849,426,1.475570612,1.875448413,519,390,181,35,'01_35_01.c3d',14,VE,R,M,1,diff,129
447,828,381,1.530486129,1.868557707,483,419,240,1,'01_35_02.c3d',14,VE,R,M,2,diff,64
448,854,406,1.32388855,1.635437804,594,408,1,169,'01_35_03.c3d',14,VE,R,M,3,diff,186
491,967,476,1.257087619,1.71768351,640,439,57,263,'01_35_04.c3d',14,VE,R,M,4,diff,201
809,875,66,1.14793709,1.138075003,675,419,120,169,'01_35_05.c3d',14,VE,R,M,5,diff,256
895,1243,348,1.073727736,1.027416829,700,427,252,271,'01_35_01.c3d',15,VE,R,M,1,diff,273
444,927,483,0.866410889,1.032473351,591,304,1,80,'01_35_02.c3d',15,VE,R,M,2,diff,287
603,852,249,0.90078894,0.49355373,545,378,1,1,'01_35_03.c3d',15,VE,R,M,3,diff,167
631,1171,540,0.755005265,1.071646924,918,440,1,272,'01_35_04.c3d',15,VE,R,M,4,diff,478
1210,1354,144,0.846058625,1.249252419,1140,798,1,1,'01_35_05.c3d',15,VE,R,M,5,diff,342
807,1206,399,0.890443358,0.96957805,659,401,1,1,'01_35_01.c3d',16,VE,R,M,1,diff,258
521,2429,1908,1.546829333,1.694782956,690,483,251,1,'01_35_02.c3d',16,VE,R,M,2,diff,207
935,1363,428,1.166418742,0.51666484,768,379,155,1,'01_35_03.c3d',16,VE,R,M,3,diff,389
601,1648,1047,1.093374616,1.243394088,779,474,292,35,'01_35_04.c3d',16,VE,R,M,4,diff,305
506,1040,534,0.89639449,1.558516281,633,425,267,1,'01_35_05.c3d',16,VE,R,M,5,diff,208
554,769,215,1.84164883,2.738120347,494,429,297,303,'01_35_01.c3d',17,VE,R,M,1,diff,65
531,609,78,1.852405565,2.046873178,519,381,248,246,'01_35_02.c3d',17,VE,R,M,2,diff,138
622,793,171,1.610545622,2.592498184,500,418,266,78,'01_35_03.c3d',17,VE,R,M,3,diff,82
480,780,300,2.04133118,1.601342675,511,374,244,235,'01_35_04.c3d',17,VE,R,M,4,diff,137
418,673,255,2.153808934,2.122918211,502,386,256,256,'01_35_05.c3d',17,VE,R,M,5,diff,116
480,1015,535,1.292047487,1.896933294,663,465,265,1,'01_35_01.c3d',18,VE,R,M,1,diff,198
448,2054,1606,1.187384951,1.700730531,495,415,1,1,'01_35_02.c3d',18,VE,R,M,2,diff,80
557,862,305,1.087236246,1.86621928,574,395,236,1,'01_35_03.c3d',18,VE,R,M,3,diff,179
434,881,447,1.072353837,1.687624674,578,403,204,143,'01_35_04.c3d',18,VE,R,M,4,diff,175
702,1023,321,0.95867041,1.954007119,795,470,1,1,'01_35_05.c3d',18,VE,R,M,5,diff,325
977,1570,593,0.574297351,0.726485804,910,516,1,299,'01_35_01.c3d',19,VE,R,M,1,diff,394
696,1106,410,0.866335871,0.807014458,741,463,1,20,'01_35_02.c3d',19,VE,R,M,2,diff,278
510,946,436,1.048893315,1.181076004,677,412,239,1,'01_35_03.c3d',19,VE,R,M,3,diff,265
598,983,385,1.085480183,1.204274952,715,505,333,1,'01_35_04.c3d',19,VE,R,M,4,diff,210
563,867,304,1.054952545,1.018524335,650,429,1,1,'01_35_05.c3d',19,VE,R,M,5,diff,221
764,1251,487,0.823273869,1.292474372,759,468,315,292,'01_35_01.c3d',20,VE,R,M,1,diff,291
590,972,382,0.98677203,1.332078187,724,437,273,222,'01_35_02.c3d',20,VE,R,M,2,diff,287
927,1172,245,0.784254906,0.92198924,806,468,1,46,'01_35_03.c3d',20,VE,R,M,3,diff,338
904,1114,210,0.95484616,1.0505377,703,487,1,15,'01_35_04.c3d',20,VE,R,M,4,diff,216
984,1601,617,0.749892505,0.758934682,777,527,366,1,'01_35_05.c3d',20,VE,R,M,5,diff,250
1015,1439,424,0.934131607,1.155260834,1333,626,1,467,'01_35_01.c3d',21,VE,R,M,1,diff,707
973,1413,440,0.807452842,0.629601023,1101,603,411,1,'01_35_02.c3d',21,VE,R,M,2,diff,498
723,1302,579,0.79933549,0.744351903,861,598,356,1,'01_35_03.c3d',21,VE,R,M,3,diff,263
1078,1305,227,0.78971447,0.490197145,1113,884,439,35,'01_35_04.c3d',21,VE,R,M,4,diff,229
809,1350,541,0.891315226,0.642287096,934,475,333,17,'01_35_05.c3d',21,VE,R,M,5,diff,459
690,1753,1063,0.775185333,1.608638305,858,644,362,1,'01_35_01.c3d',22,VE,R,M,1,diff,214
1018,1414,396,0.735311354,0.907592772,921,715,408,50,'01_35_02.c3d',22,VE,R,M,2,diff,206
899,1535,636,0.670125991,0.951853326,1047,599,398,409,'01_35_03.c3d',22,VE,R,M,3,diff,448
924,1179,255,0.858913203,0.844859136,846,522,260,290,'01_35_04.c3d',22,VE,R,M,4,diff,324
1131,1783,652,0.613497636,0.807838011,1270,818,553,562,'01_35_05.c3d',22,VE,R,M,5,diff,452
2332,3227,895,0.40481967,0.392507592,1215,851,325,311,'01_35_01.c3d',23,VE,R,M,1,diff,364
1466,2842,1376,0.417267402,0.370945468,1232,689,382,34,'01_35_02.c3d',23,VE,R,M,2,diff,543
1297,1870,573,0.420076871,0.480007497,1181,758,1,12,'01_35_03.c3d',23,VE,R,M,3,diff,423
2041,2204,163,0.363117367,0.553634428,1352,822,410,1,'01_35_04.c3d',23,VE,R,M,4,diff,530
1259,2088,829,0.42705706,0.48195923,1821,663,374,38,'01_35_05.c3d',23,VE,R,M,5,diff,1158
615,942,327,1.197523753,1.366291152,595,482,281,44,'01_35_01.c3d',24,VE,R,M,1,diff,113
641,931,290,1.111081085,0.879305414,754,424,279,19,'01_35_02.c3d',24,VE,R,M,2,diff,330
717,936,219,1.034234113,0.75020668,710,397,227,218,'01_35_03.c3d',24,VE,R,M,3,diff,313
617,1054,437,0.820196163,1.072250977,664,419,226,1,'01_35_04.c3d',24,VE,R,M,4,diff,245
704,1002,298,0.903487817,1.081633778,700,383,213,178,'01_35_05.c3d',24,VE,R,M,5,diff,317
585,1053,468,0.933167779,0.944084428,618,556,265,44,'01_35_01.c3d',25,VE,R,M,1,diff,62
692,1059,367,0.940561198,0.901718712,680,455,1,252,'01_35_02.c3d',25,VE,R,M,2,diff,225
576,1036,460,0.991111277,0.980793406,686,483,279,18,'01_35_03.c3d',25,VE,R,M,3,diff,203
853,1406,553,0.758293787,0.494201212,858,502,1,267,'01_35_04.c3d',25,VE,R,M,4,diff,356
639,1203,564,0.774055034,0.845175658,841,541,279,281,'01_35_05.c3d',25,VE,R,M,5,diff,300
1036,1246,210,0.702269103,0.974026484,969,484,286,66,'01_35_01.c3d',26,VE,R,M,1,diff,485
650,1435,785,0.557426048,0.962852312,1007,536,348,278,'01_35_02.c3d',26,VE,R,M,2,diff,471
661,1148,487,0.6145575,0.911118905,932,508,269,236,'01_35_03.c3d',26,VE,R,M,3,diff,424
1183,1307,124,0.732737411,0.748356949,969,438,284,1,'01_35_04.c3d',26,VE,R,M,4,diff,531
1234,2116,882,0.674893295,0.631062351,1006,585,1,1,'01_35_05.c3d',26,VE,R,M,5,diff,421
1408,1596,188,0.896845086,0.812336191,1291,936,630,1,'01_35_01.c3d',27,VE,R,M,1,diff,355
1215,1333,118,1.038521365,0.666501409,1134,822,570,1,'01_35_02.c3d',27,VE,R,M,2,diff,312
1449,1887,438,0.790603523,0.760534127,1242,957,1,1,'01_35_03.c3d',27,VE,R,M,3,diff,285
931,1334,403,0.826601042,0.592683118,983,710,354,299,'01_35_04.c3d',27,VE,R,M,4,diff,273
864,1617,753,0.74995398,1.058551355,917,776,1,1,'01_35_05.c3d',27,VE,R,M,5,diff,141
1094,2196,1102,0.750449206,0.927515861,1930,616,1,27,'01_35_01.c3d',28,VE,R,M,1,diff,1314
2144,2587,443,0.673647122,0.614298022,2010,1657,1402,32,'01_35_02.c3d',28,VE,R,M,2,diff,353
994,1138,144,0.875388861,0.650799163,835,520,1,270,'01_35_03.c3d',28,VE,R,M,3,diff,315
2025,2399,374,0.774072944,0.717649479,2101,1559,1,1,'01_35_04.c3d',28,VE,R,M,4,diff,542
1010,1437,427,0.738691914,0.605262473,1121,552,1,47,'01_35_05.c3d',28,VE,R,M,5,diff,569
593,1967,1374,0.999097729,1.595884575,772,558,1,1,'01_35_01.c3d',29,VE,R,M,1,diff,214
582,1685,1103,1.121739618,1.397018661,691,529,1,1,'01_35_02.c3d',29,VE,R,M,2,diff,162
611,1993,1382,0.969932664,1.141142129,731,484,305,295,'01_35_03.c3d',29,VE,R,M,3,diff,247
928,964,36,0.91391194,1.102385547,720,413,263,1,'01_35_04.c3d',29,VE,R,M,4,diff,307
620,1838,1218,0.840342491,1.150394875,704,520,1,2,'01_35_05.c3d',29,VE,R,M,5,diff,184
842,1318,476,0.608652028,0.522790508,1005,402,246,1,'01_35_01.c3d',30,VE,R,M,1,diff,603
1020,1150,130,0.837886448,0.696051296,886,545,1,1,'01_35_02.c3d',30,VE,R,M,2,diff,341
1097,1140,43,0.739065784,0.806740099,849,461,261,268,'01_35_03.c3d',30,VE,R,M,3,diff,388
835,1598,763,0.688801895,0.649433659,801,422,1,97,'01_35_04.c3d',30,VE,R,M,4,diff,379
637,1174,537,0.674747427,0.702451359,888,520,123,64,'01_35_05.c3d',30,VE,R,M,5,diff,368
637,913,276,1.687209713,2.36545894,603,458,284,274,'01_35_01.c3d',31,VE,R,M,1,diff,145
882,968,86,1.469249476,1.322587182,771,505,317,312,'01_35_02.c3d',31,VE,R,M,2,diff,266
925,933,8,1.450224675,1.352146951,746,485,302,281,'01_35_03.c3d',31,VE,R,M,3,diff,261
576,916,340,1.556305428,1.566720773,678,480,306,291,'01_35_04.c3d',31,VE,R,M,4,diff,198
885,1138,253,1.039493661,1.184082654,768,481,298,289,'01_35_05.c3d',31,VE,R,M,5,diff,287
1019,1502,483,0.871126746,0.877474251,859,578,1,1,'01_35_01.c3d',32,VE,R,M,1,diff,281
907,1180,273,1.104754445,0.488796528,669,1126,286,1,'01_35_02.c3d',32,VE,R,M,2,diff,457
851,1343,492,0.988404848,1.250480563,966,753,1,153,'01_35_03.c3d',32,VE,R,M,3,diff,213
1006,1248,242,0.757806895,0.569544349,797,554,280,263,'01_35_04.c3d',32,VE,R,M,4,diff,243
1108,1187,79,0.855535903,0.833324734,1012,559,363,1,'01_35_05.c3d',32,VE,R,M,5,diff,453
956,1459,503,0.738410303,0.777020361,1136,552,384,1,'01_35_01.c3d',33,VE,R,M,1,diff,584
1062,1083,21,1.093377647,0.743172215,866,543,1,267,'01_35_02.c3d',33,VE,R,M,2,diff,323
746,1264,518,0.885294648,0.828574661,1000,529,341,1,'01_35_03.c3d',33,VE,R,M,3,diff,471
1073,1133,60,1.128360393,0.787421123,908,545,326,1,'01_35_04.c3d',33,VE,R,M,4,diff,363
1139,3199,2060,1.037632358,1.058328753,926,532,368,351,'01_35_05.c3d',33,VE,R,M,5,diff,394
715,988,273,1.157356699,1.022181649,743,551,388,400,'01_35_01.c3d',34,VE,R,M,1,diff,192
493,990,497,1.513477644,1.550740361,609,462,286,278,'01_35_02.c3d',34,VE,R,M,2,diff,147
848,858,10,1.149367623,1.250290635,658,431,301,295,'01_35_03.c3d',34,VE,R,M,3,diff,227
900,945,45,0.973897243,1.060650869,836,432,285,285,'01_35_04.c3d',34,VE,R,M,4,diff,404
566,1222,656,0.732433974,1.04786291,789,416,1,245,'01_35_05.c3d',34,VE,R,M,5,diff,373
870,1161,291,0.899542813,1.371914806,803,454,280,272,'01_35_01.c3d',35,VE,R,M,1,diff,349
857,1608,751,0.976966188,1.314417672,691,410,250,243,'01_35_02.c3d',35,VE,R,M,2,diff,281
858,969,111,1.123682461,1.00123133,723,427,257,249,'01_35_03.c3d',35,VE,R,M,3,diff,296
569,1061,492,1.167066761,1.114333054,730,454,235,1,'01_35_04.c3d',35,VE,R,M,4,diff,276
748,1103,355,0.789206289,0.632628212,631,206,1,1,'01_35_05.c3d',35,VE,R,M,5,diff,425
650,1330,680,0.72079273,1.016570969,951,507,1,27,'01_36_01.c3d',1,VE,R,H,1,diff,444
681,3373,2692,0.850042248,0.859667598,898,495,225,242,'01_36_02.c3d',1,VE,R,H,2,diff,403
602,1175,573,0.825543231,1.160100853,1092,466,231,49,'01_36_03.c3d',1,VE,R,H,3,diff,626
905,1080,175,0.790185886,0.642209522,869,392,1,52,'01_36_04.c3d',1,VE,R,H,4,diff,477
889,1146,257,0.85145678,0.601474107,824,855,151,69,'01_36_05.c3d',1,VE,R,H,5,diff,31
793,1305,512,0.640066255,0.694722359,978,426,256,1,'01_36_01.c3d',2,VE,R,H,1,diff,552
749,1400,651,0.635251502,0.87557488,992,591,1,1,'01_36_02.c3d',2,VE,R,H,2,diff,401
822,1357,535,0.646213729,1.069365563,1107,449,316,254,'01_36_03.c3d',2,VE,R,H,3,diff,658
957,1231,274,0.946234121,0.556592904,1108,519,343,1,'01_36_04.c3d',2,VE,R,H,4,diff,589
1003,1448,445,0.790866936,0.714814896,996,533,304,1,'01_36_05.c3d',2,VE,R,H,5,diff,463
607,1119,512,1.245675417,1.632879727,779,510,1,1,'01_36_01.c3d',3,VE,R,H,1,diff,269
589,967,378,1.518193247,1.541542397,728,541,394,1,'01_36_02.c3d',3,VE,R,H,2,diff,187
574,958,384,0.975838808,1.490376155,881,461,1,1,'01_36_03.c3d',3,VE,R,H,3,diff,420
566,965,399,0.864681713,1.313090462,555,427,1,42,'01_36_04.c3d',3,VE,R,H,4,diff,128
813,1307,494,0.734715358,1.007205919,659,381,1,67,'01_36_05.c3d',3,VE,R,H,5,diff,278
571,1053,482,0.988710821,1.238593403,680,504,299,279,'01_36_01.c3d',4,VE,R,H,1,diff,176
536,974,438,0.922750969,1.316899193,624,448,268,261,'01_36_02.c3d',4,VE,R,H,2,diff,176
675,949,274,1.058866437,1.771848186,603,468,269,289,'01_36_03.c3d',4,VE,R,H,3,diff,135
552,945,393,0.84421795,1.041653578,665,406,250,1,'01_36_04.c3d',4,VE,R,H,4,diff,259
785,1224,439,0.758492765,0.669249994,806,615,350,1,'01_36_05.c3d',4,VE,R,H,5,diff,191
546,1292,746,1.771816177,1.884937089,633,517,1,350,'01_36_01.c3d',5,VE,R,H,1,diff,116
387,797,410,1.349086653,2.333567264,507,364,1,50,'01_36_02.c3d',5,VE,R,H,2,diff,143
469,937,468,1.107231372,1.863464836,551,432,299,267,'01_36_03.c3d',5,VE,R,H,3,diff,119
169,650,481,1.556196717,2.963921996,333,173,1,24,'01_36_04.c3d',5,VE,R,H,4,diff,160
476,831,355,1.159793348,1.535741451,610,431,1,1,'01_36_05.c3d',5,VE,R,H,5,diff,179
881,1725,844,0.82501463,0.858322721,1473,483,277,1,'01_36_01.c3d',6,VE,R,H,1,diff,990
723,1509,786,0.773944031,1.123773192,1389,509,1,325,'01_36_02.c3d',6,VE,R,H,2,diff,880
658,1141,483,0.932854739,1.099607747,906,483,289,1,'01_36_03.c3d',6,VE,R,H,3,diff,423
1037,1749,712,0.960744818,1.365005572,1453,551,1,380,'01_36_04.c3d',6,VE,R,H,4,diff,902
674,1241,567,0.970994273,1.132223586,1059,560,1,29,'01_36_05.c3d',6,VE,R,H,5,diff,499
1005,1986,981,1.011935088,0.80097526,808,508,1,62,'01_36_01.c3d',7,VE,R,H,1,diff,300
1037,1088,51,0.710807768,0.546854862,806,412,1,5,'01_36_02.c3d',7,VE,R,H,2,diff,394
1042,1106,64,0.974512843,0.803789646,731,547,276,4,'01_36_03.c3d',7,VE,R,H,3,diff,184
159,1272,1113,0.895716004,0.902800733,1,98,1,1,'01_36_04.c3d',7,VE,R,H,4,diff,97
565,1162,597,0.720448868,0.875186123,879,401,1,39,'01_36_05.c3d',7,VE,R,H,5,diff,478
971,1638,667,0.731582299,0.893220752,766,538,319,29,'01_36_01.c3d',8,VE,R,H,1,diff,228
903,1778,875,0.416570557,0.723220674,716,458,1,92,'01_36_02.c3d',8,VE,R,H,2,diff,258
912,1431,519,0.580440945,0.624397718,885,471,247,269,'01_36_03.c3d',8,VE,R,H,3,diff,414
924,1469,545,0.572646474,0.653313923,928,439,231,26,'01_36_04.c3d',8,VE,R,H,4,diff,489
863,1370,507,0.6131018,0.600292262,698,483,1,72,'01_36_05.c3d',8,VE,R,H,5,diff,215
839,2455,1616,0.503396307,1.101739761,588,476,1,331,'01_36_01.c3d',9,VE,R,H,1,diff,112
701,1986,1285,0.830677415,1.194695165,1182,407,355,262,'01_36_02.c3d',9,VE,R,H,2,diff,775
759,2024,1265,0.622899656,0.84267334,715,426,244,234,'01_36_03.c3d',9,VE,R,H,3,diff,289
538,1988,1450,0.679823944,1.140044181,546,448,222,36,'01_36_04.c3d',9,VE,R,H,4,diff,98
800,2197,1397,0.506413238,0.987945156,675,586,1,18,'01_36_05.c3d',9,VE,R,H,5,diff,89
971,1173,202,1.090765144,0.85902032,758,545,1,1,'01_36_01.c3d',10,VE,R,H,1,diff,213
693,1131,438,0.894106164,1.327733343,855,550,328,338,'01_36_02.c3d',10,VE,R,H,2,diff,305
658,1135,477,0.858221767,1.416652495,768,536,265,94,'01_36_03.c3d',10,VE,R,H,3,diff,232
844,1062,218,0.876082243,1.164781964,756,450,217,219,'01_36_04.c3d',10,VE,R,H,4,diff,306
817,1078,261,0.909682278,0.882220035,533,383,219,1,'01_36_05.c3d',10,VE,R,H,5,diff,150
711,1066,355,0.866773949,0.951007905,885,575,347,1,'01_36_01.c3d',11,VE,R,H,1,diff,310
1176,1872,696,0.423344802,0.61082694,1171,672,366,1,'01_36_02.c3d',11,VE,R,H,2,diff,499
1675,1972,297,0.400480412,0.388788215,1448,1179,1,79,'01_36_03.c3d',11,VE,R,H,3,diff,269
1104,1769,665,0.424915641,0.48073563,1163,614,373,331,'01_36_04.c3d',11,VE,R,H,4,diff,549
996,1474,478,0.503858474,0.720842589,1019,551,292,1,'01_36_05.c3d',11,VE,R,H,5,diff,468
850,1510,660,0.685526513,0.718401875,565,429,254,263,'01_36_01.c3d',12,VE,R,H,1,diff,136
945,1393,448,0.620420761,0.717175599,758,458,1,274,'01_36_02.c3d',12,VE,R,H,2,diff,300
921,1179,258,0.692434182,0.77632679,693,510,286,18,'01_36_03.c3d',12,VE,R,H,3,diff,183
898,1220,322,0.654097973,0.724380075,729,413,1,88,'01_36_04.c3d',12,VE,R,H,4,diff,316
809,1389,580,0.651152577,0.616401516,810,442,265,1,'01_36_05.c3d',12,VE,R,H,5,diff,368
928,1233,305,0.940392427,0.853271125,827,472,1,58,'01_36_01.c3d',13,VE,R,H,1,diff,355
540,902,362,1.154583482,1.230775942,646,444,1,27,'01_36_02.c3d',13,VE,R,H,2,diff,202
917,1274,357,1.111541472,1.011553302,723,438,259,1,'01_36_03.c3d',13,VE,R,H,3,diff,285
949,1056,107,1.022570709,0.981138919,815,500,234,1,'01_36_04.c3d',13,VE,R,H,4,diff,315
702,2546,1844,0.992505203,1.170608399,869,584,1,34,'01_36_05.c3d',13,VE,R,H,5,diff,285
412,743,331,1.321968405,2.024275243,571,391,1,195,'01_36_01.c3d',14,VE,R,H,1,diff,180
684,2244,1560,1.359132977,1.755742234,651,478,1,1,'01_36_02.c3d',14,VE,R,H,2,diff,173
678,739,61,1.277773305,1.221208888,531,366,122,11,'01_36_03.c3d',14,VE,R,H,3,diff,165
521,1154,633,1.262369513,1.52686726,506,446,1,276,'01_36_04.c3d',14,VE,R,H,4,diff,60
733,990,257,0.981512606,0.898861606,475,415,221,53,'01_36_05.c3d',14,VE,R,H,5,diff,60
942,2068,1126,1.027013,0.989532728,765,495,262,15,'01_36_01.c3d',15,VE,R,H,1,diff,270
888,938,50,0.968622149,0.787021948,669,371,209,1,'01_36_02.c3d',15,VE,R,H,2,diff,298
351,906,555,0.804702177,0.94061956,691,256,1,1,'01_36_03.c3d',15,VE,R,H,3,diff,435
853,1191,338,0.733402437,1.023120259,714,430,247,236,'01_36_04.c3d',15,VE,R,H,4,diff,284
610,1153,543,0.751739057,0.785259228,672,347,1,1,'01_36_05.c3d',15,VE,R,H,5,diff,325
751,1088,337,0.977385185,0.891113993,683,362,1,1,'01_36_01.c3d',16,VE,R,H,1,diff,321
664,1008,344,1.073318708,0.738618885,752,455,242,1,'01_36_02.c3d',16,VE,R,H,2,diff,297
909,1169,260,1.052834723,1.006286044,692,339,1,135,'01_36_03.c3d',16,VE,R,H,3,diff,353
729,1720,991,0.971674429,0.786555189,727,412,1,12,'01_36_04.c3d',16,VE,R,H,4,diff,315
771,861,90,1.054224972,1.072813571,640,267,1,44,'01_36_05.c3d',16,VE,R,H,5,diff,373
600,769,169,1.635724533,2.041578613,623,471,330,1,'01_36_01.c3d',17,VE,R,H,1,diff,152
562,723,161,1.60168101,1.960509409,535,431,279,288,'01_36_02.c3d',17,VE,R,H,2,diff,104
476,732,256,1.624382224,1.480745572,553,391,260,259,'01_36_03.c3d',17,VE,R,H,3,diff,162
412,782,370,1.279779641,2.803889946,605,391,282,286,'01_36_04.c3d',17,VE,R,H,4,diff,214
866,1173,307,1.150785135,1.303818512,577,428,271,207,'01_36_05.c3d',17,VE,R,H,5,diff,149
1228,1440,212,0.809443001,2.186284489,842,593,402,1,'01_36_01.c3d',18,VE,R,H,1,diff,249
566,959,393,1.139559583,1.533115482,698,514,328,1,'01_36_02.c3d',18,VE,R,H,2,diff,184
627,1068,441,1.126087717,1.404721082,782,533,1,78,'01_36_03.c3d',18,VE,R,H,3,diff,249
478,969,491,0.967909109,1.836798963,657,441,198,80,'01_36_04.c3d',18,VE,R,H,4,diff,216
507,900,393,0.872928173,1.34366007,656,440,1,46,'01_36_05.c3d',18,VE,R,H,5,diff,216
874,1509,635,0.623823386,0.909170789,1289,575,1,271,'01_36_01.c3d',19,VE,R,H,1,diff,714
857,1071,214,0.94095911,1.069208226,755,462,288,1,'01_36_02.c3d',19,VE,R,H,2,diff,293
708,1160,452,0.679516173,0.682954287,859,397,1,64,'01_36_03.c3d',19,VE,R,H,3,diff,462
876,1144,268,0.871747284,1.100801882,788,479,328,64,'01_36_04.c3d',19,VE,R,H,4,diff,309
987,1354,367,0.695624438,0.694820803,807,622,1,6,'01_36_05.c3d',19,VE,R,H,5,diff,185
709,1220,511,0.898080362,1.214903676,696,432,279,1,'01_36_01.c3d',20,VE,R,H,1,diff,264
853,1409,556,0.667524715,1.016395418,744,465,1,1,'01_36_02.c3d',20,VE,R,H,2,diff,279
714,1286,572,0.706137191,0.985356812,722,403,263,220,'01_36_03.c3d',20,VE,R,H,3,diff,319
953,1562,609,0.581829448,0.956977789,734,454,283,1,'01_36_04.c3d',20,VE,R,H,4,diff,280
942,1134,192,0.764460467,1.10911446,703,408,1,241,'01_36_05.c3d',20,VE,R,H,5,diff,295
1199,1363,164,0.796028909,1.009092999,1174,686,1,31,'01_36_01.c3d',21,VE,R,H,1,diff,488
1141,1607,466,0.506233669,0.523396275,1081,652,1,62,'01_36_02.c3d',21,VE,R,H,2,diff,429
1084,1419,335,0.609049314,0.688392436,857,470,21,204,'01_36_03.c3d',21,VE,R,H,3,diff,387
1350,1444,94,0.576114517,0.506880383,1079,467,1,72,'01_36_04.c3d',21,VE,R,H,4,diff,612
699,1256,557,0.690096928,0.76223594,936,650,298,30,'01_36_05.c3d',21,VE,R,H,5,diff,286
718,1460,742,0.65000144,1.063179316,839,609,1,337,'01_36_01.c3d',22,VE,R,H,1,diff,230
1102,1666,564,0.657232771,0.792239172,900,567,293,303,'01_36_02.c3d',22,VE,R,H,2,diff,333
1128,1799,671,0.48483317,1.128620051,1509,605,341,1,'01_36_03.c3d',22,VE,R,H,3,diff,904
1045,1789,744,0.636509793,0.998160772,1464,624,370,390,'01_36_04.c3d',22,VE,R,H,4,diff,840
976,1280,304,0.764704353,0.719638131,937,618,302,101,'01_36_05.c3d',22,VE,R,H,5,diff,319
1667,2510,843,0.338415635,0.312320265,1827,834,301,1,'01_36_01.c3d',23,VE,R,H,1,diff,993
1758,1976,218,0.424075657,0.502773694,1549,644,234,242,'01_36_02.c3d',23,VE,R,H,2,diff,905
2132,2533,401,0.422611896,0.464982938,1226,2143,414,406,'01_36_03.c3d',23,VE,R,H,3,diff,917
1784,3057,1273,0.378234278,0.451615176,1335,602,337,19,'01_36_04.c3d',23,VE,R,H,4,diff,733
2108,2358,250,0.457398286,0.45631151,1149,532,299,24,'01_36_05.c3d',23,VE,R,H,5,diff,617
571,1001,430,1.024754124,1.584803593,733,422,240,239,'01_36_01.c3d',24,VE,R,H,1,diff,311
934,1003,69,0.971875312,1.115800396,770,453,276,258,'01_36_02.c3d',24,VE,R,H,2,diff,317
929,1083,154,0.80448943,0.843151271,825,430,243,1,'01_36_03.c3d',24,VE,R,H,3,diff,395
802,1011,209,0.909153473,1.025553209,706,362,190,141,'01_36_04.c3d',24,VE,R,H,4,diff,344
887,1189,302,0.883779378,0.520865295,760,845,154,1,'01_36_05.c3d',24,VE,R,H,5,diff,85
597,1025,428,1.085527612,0.813008055,666,498,263,236,'01_36_01.c3d',25,VE,R,H,1,diff,168
609,955,346,1.031309669,0.835049935,737,456,257,252,'01_36_02.c3d',25,VE,R,H,2,diff,281
651,1201,550,0.899177318,0.779033926,671,444,1,198,'01_36_03.c3d',25,VE,R,H,3,diff,227
653,1124,471,0.840186898,0.753744526,841,455,253,1,'01_36_04.c3d',25,VE,R,H,4,diff,386
872,1339,467,0.888633262,0.622504185,792,629,293,1,'01_36_05.c3d',25,VE,R,H,5,diff,163
1167,2315,1148,0.717014848,0.639240029,868,493,321,36,'01_36_01.c3d',26,VE,R,H,1,diff,375
605,1274,669,0.788810918,0.881784678,1131,520,329,206,'01_36_02.c3d',26,VE,R,H,2,diff,611
965,3439,2474,0.541437726,0.747984655,1292,448,1,101,'01_36_03.c3d',26,VE,R,H,3,diff,844
1488,1762,274,0.653490225,0.590509981,1175,490,1,103,'01_36_04.c3d',26,VE,R,H,4,diff,685
751,1635,884,0.685327864,0.78707728,950,513,1,63,'01_36_05.c3d',26,VE,R,H,5,diff,437
808,1256,448,1.010430633,1.059712138,1063,670,448,420,'01_36_01.c3d',27,VE,R,H,1,diff,393
1133,1289,156,1.051518451,0.830695979,1047,700,509,1,'01_36_02.c3d',27,VE,R,H,2,diff,347
1366,1736,370,0.661956447,0.712589339,1247,762,1,548,'01_36_03.c3d',27,VE,R,H,3,diff,485
1329,1819,490,0.645633048,0.557831918,1386,1201,553,1,'01_36_04.c3d',27,VE,R,H,4,diff,185
1389,1819,430,0.728101531,0.616299099,1007,880,1,1,'01_36_05.c3d',27,VE,R,H,5,diff,127
1068,2118,1050,0.719063044,0.909336645,1670,672,1,54,'01_36_01.c3d',28,VE,R,H,1,diff,998
1086,2137,1051,0.69370069,0.811455682,1883,615,734,409,'01_36_02.c3d',28,VE,R,H,2,diff,1268
1127,1734,607,0.853209268,0.832405228,1006,527,277,288,'01_36_03.c3d',28,VE,R,H,3,diff,479
959,2717,1758,0.66751579,1.019129293,1192,476,313,1,'01_36_04.c3d',28,VE,R,H,4,diff,716
1162,1224,62,0.905832035,0.578243075,1065,657,314,45,'01_36_05.c3d',28,VE,R,H,5,diff,408
530,3058,2528,1.219564621,1.693772452,649,460,322,1,'01_36_01.c3d',29,VE,R,H,1,diff,189
589,975,386,0.999526012,1.046172812,672,447,268,1,'01_36_02.c3d',29,VE,R,H,2,diff,225
522,1085,563,0.711739864,1.032646263,772,403,1,1,'01_36_03.c3d',29,VE,R,H,3,diff,369
526,954,428,0.95162306,1.378339543,731,443,1,1,'01_36_04.c3d',29,VE,R,H,4,diff,288
898,1060,162,0.728334432,0.753539749,759,415,209,195,'01_36_05.c3d',29,VE,R,H,5,diff,344
575,1172,597,0.825889788,1.060378564,759,479,301,286,'01_36_01.c3d',30,VE,R,H,1,diff,280
940,1321,381,0.595350659,0.786802748,884,454,184,243,'01_36_02.c3d',30,VE,R,H,2,diff,430
879,1262,383,0.693334143,0.863952457,946,437,1,202,'01_36_03.c3d',30,VE,R,H,3,diff,509
995,1066,71,0.759417719,0.588043946,816,363,1,182,'01_36_04.c3d',30,VE,R,H,4,diff,453
1095,1203,108,0.780676137,0.65822127,896,482,1,31,'01_36_05.c3d',30,VE,R,H,5,diff,414
1322,2061,739,0.73051869,0.868436981,1951,700,1,1,'01_36_01.c3d',31,VE,R,H,1,diff,1251
505,1047,542,1.475084197,2.116955214,740,455,301,295,'01_36_02.c3d',31,VE,R,H,2,diff,285
907,1091,184,1.277775098,1.112926436,913,513,338,17,'01_36_03.c3d',31,VE,R,H,3,diff,400
922,973,51,1.48968007,1.650575715,668,446,313,301,'01_36_04.c3d',31,VE,R,H,4,diff,222
552,1047,495,1.15812873,1.07244366,766,415,242,176,'01_36_05.c3d',31,VE,R,H,5,diff,351
1112,1113,1,0.942331881,0.609349667,763,517,345,31,'01_36_01.c3d',32,VE,R,H,1,diff,246
1225,1400,175,0.819354036,0.80024912,1056,830,535,83,'01_36_02.c3d',32,VE,R,H,2,diff,226
1031,1370,339,0.667912712,0.508256889,841,559,309,262,'01_36_03.c3d',32,VE,R,H,3,diff,282
1048,1353,305,0.765975301,0.662381968,852,527,305,35,'01_36_04.c3d',32,VE,R,H,4,diff,325
1013,1282,269,0.7683817,0.496392553,925,505,304,263,'01_36_05.c3d',32,VE,R,H,5,diff,420
901,1378,477,0.850533376,0.766104173,1123,652,432,387,'01_36_01.c3d',33,VE,R,H,1,diff,471
845,1257,412,1.04588449,0.733551658,1013,683,460,4,'01_36_02.c3d',33,VE,R,H,2,diff,330
966,1232,266,0.997965369,0.857965316,922,517,1,308,'01_36_03.c3d',33,VE,R,H,3,diff,405
1007,1315,308,0.760152878,0.810300892,977,586,329,24,'01_36_04.c3d',33,VE,R,H,4,diff,391
974,1348,374,0.82409655,0.92028334,1031,601,411,34,'01_36_05.c3d',33,VE,R,H,5,diff,430
615,1019,404,1.046026018,1.375579658,692,504,1,1,'01_36_01.c3d',34,VE,R,H,1,diff,188
1034,1036,2,0.931504414,0.57169697,713,453,312,171,'01_36_02.c3d',34,VE,R,H,2,diff,260
969,1472,503,0.821652384,0.882737116,1066,625,479,44,'01_36_03.c3d',34,VE,R,H,3,diff,441
624,1078,454,1.099236098,0.753706466,865,445,272,71,'01_36_04.c3d',34,VE,R,H,4,diff,420
578,946,368,0.890316408,0.866726531,727,383,1,1,'01_36_05.c3d',34,VE,R,H,5,diff,344
888,1186,298,0.952612435,0.888881616,865,472,1,283,'01_36_01.c3d',35,VE,R,H,1,diff,393
760,1121,361,0.90019546,1.123580453,739,380,1,211,'01_36_02.c3d',35,VE,R,H,2,diff,359
623,1026,403,1.110864879,1.154258701,753,442,241,246,'01_36_03.c3d',35,VE,R,H,3,diff,311
632,1102,470,0.978751416,1.028771435,694,417,1,246,'01_36_04.c3d',35,VE,R,H,4,diff,277
480,1081,601,0.863112612,0.865354768,621,248,1,1,'01_36_05.c3d',35,VE,R,H,5,diff,373
723,1786,1063,1.81879786,2.394259579,453,506,1,102,'01_37_01.c3d',1,A,B,N,1,neut,53
1035,2503,1468,1.113651372,1.63786061,703,753,1,1,'01_37_02.c3d',1,A,B,N,2,neut,50
1439,1575,136,2.292576002,2.651240906,716,724,388,398,'01_37_03.c3d',1,A,B,N,3,neut,8
998,1195,197,1.030700334,1.669758261,424,584,1,82,'01_37_04.c3d',1,A,B,N,4,neut,160
1165,1211,46,1.721174685,1.884756874,717,694,372,1,'01_37_05.c3d',1,A,B,N,5,neut,23
1430,1881,451,1.441531378,1.696039637,701,739,1,120,'01_37_01.c3d',2,A,B,N,1,neut,38
1140,1165,25,1.204032387,1.693920397,620,614,317,267,'01_37_02.c3d',2,A,B,N,2,neut,6
1290,1865,575,1.455924601,1.612752886,631,668,339,359,'01_37_03.c3d',2,A,B,N,3,neut,37
1240,1458,218,1.581864131,1.83773005,668,645,420,170,'01_37_04.c3d',2,A,B,N,4,neut,23
1597,1725,128,1.646570637,1.5535257,683,600,296,1,'01_37_05.c3d',2,A,B,N,5,neut,83
844,966,122,2.378336641,2.594627749,536,490,286,77,'01_37_01.c3d',3,A,B,N,1,neut,46
872,925,53,2.427861781,2.813675965,533,548,285,296,'01_37_02.c3d',3,A,B,N,2,neut,15
825,839,14,2.196191687,2.493807209,484,466,229,1,'01_37_03.c3d',3,A,B,N,3,neut,18
663,907,244,1.903222866,2.046489875,411,447,24,126,'01_37_04.c3d',3,A,B,N,4,neut,36
903,1252,349,1.769650031,1.914507062,526,687,1,6,'01_37_05.c3d',3,A,B,N,5,neut,161
968,982,14,2.239563622,2.134518718,625,623,1,372,'01_37_01.c3d',4,A,B,N,1,neut,2
1093,1103,10,1.800583577,1.990994104,639,660,19,1,'01_37_02.c3d',4,A,B,N,2,neut,21
1008,1331,323,1.993694161,2.063199857,558,584,300,278,'01_37_03.c3d',4,A,B,N,3,neut,26
1423,1430,7,2.046980232,1.911678502,519,526,237,279,'01_37_04.c3d',4,A,B,N,4,neut,7
1336,1401,65,1.848969983,1.764167496,671,620,311,323,'01_37_05.c3d',4,A,B,N,5,neut,51
797,998,201,2.440047604,2.594144615,486,492,283,278,'01_37_01.c3d',5,A,B,N,1,neut,6
677,742,65,3.103590604,2.976658829,435,465,278,272,'01_37_02.c3d',5,A,B,N,2,neut,30
650,864,214,3.67312454,4.456300453,401,409,263,274,'01_37_03.c3d',5,A,B,N,3,neut,8
724,949,225,3.302243182,3.164178575,401,404,168,151,'01_37_04.c3d',5,A,B,N,4,neut,3
1000,1094,94,2.772209207,3.554992899,487,482,315,312,'01_37_05.c3d',5,A,B,N,5,neut,5
1078,1149,71,1.959517899,2.306638276,571,589,283,309,'01_37_01.c3d',6,A,B,N,1,neut,18
1056,1510,454,2.6448214,2.964724092,723,633,1,390,'01_37_02.c3d',6,A,B,N,2,neut,90
1089,1671,582,2.180757191,2.082806877,730,694,1,427,'01_37_03.c3d',6,A,B,N,3,neut,36
965,1145,180,1.403815319,1.578977857,695,704,1,341,'01_37_04.c3d',6,A,B,N,4,neut,9
960,972,12,1.629555276,2.142952317,658,645,336,318,'01_37_05.c3d',6,A,B,N,5,neut,13
1108,1296,188,1.753712945,1.80448801,628,710,332,1,'01_37_01.c3d',7,A,B,N,1,neut,82
1017,1101,84,2.164204346,2.064485573,547,530,1,241,'01_37_02.c3d',7,A,B,N,2,neut,17
656,776,120,1.619927209,1.88859895,361,354,1,1,'01_37_03.c3d',7,A,B,N,3,neut,7
935,1097,162,1.776067753,1.764139063,424,406,41,1,'01_37_04.c3d',7,A,B,N,4,neut,18
1046,1114,68,1.983489701,1.724176635,521,623,274,1,'01_37_05.c3d',7,A,B,N,5,neut,102
1393,1615,222,1.930558276,2.354045434,665,685,344,333,'01_37_01.c3d',8,A,B,N,1,neut,20
1351,1907,556,1.356648933,1.648367062,585,621,297,284,'01_37_02.c3d',8,A,B,N,2,neut,36
1610,2467,857,1.256353871,1.427297782,1045,1021,647,740,'01_37_03.c3d',8,A,B,N,3,neut,24
1919,2188,269,1.181393734,1.181209148,678,632,343,373,'01_37_04.c3d',8,A,B,N,4,neut,46
1978,2693,715,1.30183882,1.356620802,1395,1452,75,81,'01_37_05.c3d',8,A,B,N,5,neut,57
1431,2302,871,1.421360949,1.525854441,1118,1115,873,23,'01_37_01.c3d',9,A,B,N,1,neut,3
925,1783,858,1.676787336,2.054013791,568,502,315,256,'01_37_02.c3d',9,A,B,N,2,neut,66
1134,1295,161,2.449729177,2.386596254,576,524,318,1,'01_37_03.c3d',9,A,B,N,3,neut,52
1141,1302,161,1.93371956,1.960572871,586,559,288,277,'01_37_04.c3d',9,A,B,N,4,neut,27
1261,2158,897,1.715900552,1.749376184,579,475,282,273,'01_37_05.c3d',9,A,B,N,5,neut,104
840,1073,233,3.588056026,3.094125135,502,487,290,303,'01_37_01.c3d',10,A,B,N,1,neut,15
861,1199,338,2.441774746,3.895812791,515,528,277,299,'01_37_02.c3d',10,A,B,N,2,neut,13
788,1279,491,2.519817385,3.438259783,466,463,53,246,'01_37_03.c3d',10,A,B,N,3,neut,3
1196,1379,183,1.863659626,1.786985357,493,483,82,45,'01_37_04.c3d',10,A,B,N,4,neut,10
962,1364,402,1.913749193,2.192623884,585,500,282,231,'01_37_05.c3d',10,A,B,N,5,neut,85
1582,2430,848,1.6625323,1.753845229,844,903,446,1,'01_37_01.c3d',11,A,B,N,1,neut,59
1396,1465,69,1.035810264,1.25750422,796,884,1,1,'01_37_02.c3d',11,A,B,N,2,neut,88
1300,1415,115,1.284203395,1.343063824,764,756,187,334,'01_37_03.c3d',11,A,B,N,3,neut,8
1875,2785,910,1.229063065,1.202740627,1215,1237,1,768,'01_37_04.c3d',11,A,B,N,4,neut,22
1244,1685,441,1.312664966,1.608232202,833,876,467,478,'01_37_05.c3d',11,A,B,N,5,neut,43
815,929,114,1.936792577,1.836486521,489,557,304,299,'01_37_01.c3d',12,A,B,N,1,neut,68
747,1349,602,1.639588838,1.550399183,491,517,294,291,'01_37_02.c3d',12,A,B,N,2,neut,26
933,1814,881,1.774766222,1.751156439,522,528,281,193,'01_37_03.c3d',12,A,B,N,3,neut,6
849,1400,551,1.770981686,1.948977534,538,559,309,316,'01_37_04.c3d',12,A,B,N,4,neut,21
907,1591,684,2.11551412,2.347049593,435,460,54,194,'01_37_05.c3d',12,A,B,N,5,neut,25
1314,1810,496,1.743030731,1.524700097,768,813,447,444,'01_37_01.c3d',13,A,B,N,1,neut,45
961,1005,44,2.3200683,2.027914084,626,638,324,1,'01_37_02.c3d',13,A,B,N,2,neut,12
959,997,38,2.17241185,2.301936845,541,548,266,232,'01_37_03.c3d',13,A,B,N,3,neut,7
1095,1147,52,2.172584571,2.674502391,651,653,355,1,'01_37_04.c3d',13,A,B,N,4,neut,2
973,1039,66,2.004914584,2.624096646,548,602,294,318,'01_37_05.c3d',13,A,B,N,5,neut,54
804,811,7,2.447667005,3.822505702,416,488,1,253,'01_37_01.c3d',14,A,B,N,1,neut,72
748,887,139,2.576008606,3.469127717,414,476,235,257,'01_37_02.c3d',14,A,B,N,2,neut,62
740,1214,474,2.213507544,2.570619539,408,492,117,251,'01_37_03.c3d',14,A,B,N,3,neut,84
723,822,99,2.169525874,2.898995049,413,486,1,238,'01_37_04.c3d',14,A,B,N,4,neut,73
867,1163,296,2.810485694,2.420055433,443,544,231,246,'01_37_05.c3d',14,A,B,N,5,neut,101
786,787,1,2.494675588,2.889050005,485,537,248,35,'01_37_01.c3d',15,A,B,N,1,neut,52
855,969,114,2.356409759,2.5941228,506,574,83,264,'01_37_02.c3d',15,A,B,N,2,neut,68
840,1228,388,2.195809376,2.397262857,494,501,253,129,'01_37_03.c3d',15,A,B,N,3,neut,7
1164,1183,19,2.213217981,2.649127362,550,566,287,307,'01_37_04.c3d',15,A,B,N,4,neut,16
973,1400,427,2.102814868,2.147972696,568,568,223,172,'01_37_05.c3d',15,A,B,N,5,neut,0
979,1030,51,2.675164185,3.083653593,609,599,318,1,'01_37_01.c3d',16,A,B,N,1,neut,10
934,1449,515,1.731350468,2.760517087,579,557,285,300,'01_37_02.c3d',16,A,B,N,2,neut,22
1209,1736,527,2.04965102,1.692481329,689,723,1,1,'01_37_03.c3d',16,A,B,N,3,neut,34
1347,1820,473,1.768428217,2.072630351,619,646,366,390,'01_37_04.c3d',16,A,B,N,4,neut,27
897,1080,183,1.856931677,2.009362172,562,529,245,208,'01_37_05.c3d',16,A,B,N,5,neut,33
696,699,3,4.102470191,4.670638848,415,417,251,268,'01_37_01.c3d',17,A,B,N,1,neut,2
719,728,9,3.882826361,3.918740048,454,454,301,290,'01_37_02.c3d',17,A,B,N,2,neut,0
898,965,67,3.698406908,3.628902603,405,424,269,275,'01_37_03.c3d',17,A,B,N,3,neut,19
1143,1222,79,3.455416568,4.251695031,415,437,281,280,'01_37_04.c3d',17,A,B,N,4,neut,22
653,1115,462,4.405713989,3.55053395,396,421,260,261,'01_37_05.c3d',17,A,B,N,5,neut,25
1008,1145,137,2.35460499,3.041811816,601,620,351,71,'01_37_01.c3d',18,A,B,N,1,neut,19
1016,1752,736,2.84548063,2.830857813,567,561,37,307,'01_37_02.c3d',18,A,B,N,2,neut,6
1258,1420,162,2.84212858,3.194910837,618,607,1,1,'01_37_03.c3d',18,A,B,N,3,neut,11
1225,2361,1136,2.424019377,2.856730224,662,673,14,230,'01_37_04.c3d',18,A,B,N,4,neut,11
838,1022,184,1.771599549,2.182934515,460,490,1,1,'01_37_05.c3d',18,A,B,N,5,neut,30
1324,1363,39,2.108687605,2.625897233,1051,1055,816,829,'01_37_01.c3d',19,A,B,N,1,neut,4
1063,1494,431,1.545524012,2.129651503,619,600,327,356,'01_37_02.c3d',19,A,B,N,2,neut,19
875,1012,137,1.502065268,2.015100026,670,661,18,213,'01_37_03.c3d',19,A,B,N,3,neut,9
1075,1436,361,1.287410432,1.477595822,682,549,1,268,'01_37_04.c3d',19,A,B,N,4,neut,133
683,901,218,1.576483946,1.559381902,523,465,217,73,'01_37_05.c3d',19,A,B,N,5,neut,58
941,969,28,2.158257199,2.705339926,581,580,333,343,'01_37_01.c3d',20,A,B,N,1,neut,1
1082,1114,32,2.417261353,2.717364106,606,619,365,368,'01_37_02.c3d',20,A,B,N,2,neut,13
1083,1106,23,2.583130832,2.616325874,593,601,306,290,'01_37_03.c3d',20,A,B,N,3,neut,8
1233,1693,460,1.917661911,2.184946339,547,538,280,262,'01_37_04.c3d',20,A,B,N,4,neut,9
1247,1811,564,1.962971327,1.998929547,701,666,430,413,'01_37_05.c3d',20,A,B,N,5,neut,35
1160,1330,170,1.095119442,1.346881149,735,721,447,288,'01_37_01.c3d',21,A,B,N,1,neut,14
1099,1368,269,2.015069868,2.070677679,665,692,385,421,'01_37_02.c3d',21,A,B,N,2,neut,27
1078,1853,775,1.739826095,1.384925061,627,646,1,363,'01_37_03.c3d',21,A,B,N,3,neut,19
998,1577,579,1.943398182,1.937534323,599,584,315,307,'01_37_04.c3d',21,A,B,N,4,neut,15
1131,1220,89,1.659307237,1.977922608,602,637,90,312,'01_37_05.c3d',21,A,B,N,5,neut,35
934,1087,153,1.768418914,1.630896338,546,792,303,300,'01_37_01.c3d',22,A,B,N,1,neut,246
1164,1308,144,1.76280498,2.164088167,749,852,389,440,'01_37_02.c3d',22,A,B,N,2,neut,103
1078,1130,52,1.470717288,2.356776158,681,787,276,351,'01_37_03.c3d',22,A,B,N,3,neut,106
1066,1168,102,1.313660419,1.732363944,963,904,411,425,'01_37_04.c3d',22,A,B,N,4,neut,59
1224,1465,241,1.877872362,2.217856754,868,893,431,454,'01_37_05.c3d',22,A,B,N,5,neut,25
1531,2492,961,1.336083237,1.29134579,742,754,362,364,'01_37_01.c3d',23,A,B,N,1,neut,12
1625,2512,887,0.882919811,0.893558713,671,708,269,260,'01_37_02.c3d',23,A,B,N,2,neut,37
2261,2773,512,0.815459302,1.055914541,737,729,330,329,'01_37_03.c3d',23,A,B,N,3,neut,8
2767,4244,1477,0.655106727,1.08469396,720,728,299,335,'01_37_04.c3d',23,A,B,N,4,neut,8
2828,3358,530,0.523526629,0.494889613,515,502,1,14,'01_37_05.c3d',23,A,B,N,5,neut,13
871,1012,141,2.220036214,2.608795401,483,554,263,275,'01_37_01.c3d',24,A,B,N,1,neut,71
863,960,97,2.307597053,2.550302685,519,528,242,268,'01_37_02.c3d',24,A,B,N,2,neut,9
1054,1153,99,2.451794178,2.720859896,646,643,349,343,'01_37_03.c3d',24,A,B,N,3,neut,3
987,1037,50,1.981403489,2.337756208,562,527,270,244,'01_37_04.c3d',24,A,B,N,4,neut,35
1066,1123,57,1.898646506,2.208105289,672,685,326,325,'01_37_05.c3d',24,A,B,N,5,neut,13
1277,1679,402,1.650781929,1.709991606,735,737,496,477,'01_37_01.c3d',25,A,B,N,1,neut,2
881,934,53,2.396903235,2.57957431,534,518,270,277,'01_37_02.c3d',25,A,B,N,2,neut,16
1034,1222,188,1.937316145,1.816403709,581,575,259,267,'01_37_03.c3d',25,A,B,N,3,neut,6
917,1035,118,1.727587181,1.7286516,537,566,280,281,'01_37_04.c3d',25,A,B,N,4,neut,29
1122,1198,76,1.5350284,1.533051705,579,586,256,270,'01_37_05.c3d',25,A,B,N,5,neut,7
1580,1637,57,2.025093671,2.318409643,619,636,307,310,'01_37_01.c3d',26,A,B,N,1,neut,17
1412,3244,1832,1.765828954,1.852073512,609,740,279,300,'01_37_02.c3d',26,A,B,N,2,neut,131
1503,3176,1673,0.679918446,1.89937562,613,681,331,341,'01_37_03.c3d',26,A,B,N,3,neut,68
1028,1522,494,1.333873196,1.216002276,420,472,1,1,'01_37_04.c3d',26,A,B,N,4,neut,52
1594,1838,244,1.292479751,1.273456906,766,600,392,374,'01_37_05.c3d',26,A,B,N,5,neut,166
1169,1194,25,2.717177715,3.065929736,792,840,510,506,'01_37_01.c3d',27,A,B,N,1,neut,48
1086,1444,358,1.960370771,2.198788507,733,751,1,409,'01_37_02.c3d',27,A,B,N,2,neut,18
1087,2070,983,1.662554854,2.251010554,1009,1003,658,639,'01_37_03.c3d',27,A,B,N,3,neut,6
1285,1364,79,1.755444935,2.165970838,1156,1171,802,1,'01_37_04.c3d',27,A,B,N,4,neut,15
1126,1398,272,1.677225936,1.784908486,884,818,532,467,'01_37_05.c3d',27,A,B,N,5,neut,66
1234,2711,1477,0.824318722,1.472519916,1773,907,1,547,'01_37_01.c3d',28,A,B,N,1,neut,866
1081,1926,845,0.910888287,1.353701328,774,937,1,404,'01_37_02.c3d',28,A,B,N,2,neut,163
1334,1771,437,0.970163736,0.973367892,811,743,1,454,'01_37_03.c3d',28,A,B,N,3,neut,68
1640,1641,1,1.328887409,1.83228385,878,883,561,553,'01_37_04.c3d',28,A,B,N,4,neut,5
1299,1393,94,0.999443335,1.650929029,794,860,345,510,'01_37_05.c3d',28,A,B,N,5,neut,66
935,2114,1179,2.803043417,2.935538788,739,698,1,490,'01_37_01.c3d',29,A,B,N,1,neut,41
917,2443,1526,1.591227705,2.24797895,531,553,266,269,'01_37_02.c3d',29,A,B,N,2,neut,22
969,1332,363,2.046624623,2.13121121,520,568,273,281,'01_37_03.c3d',29,A,B,N,3,neut,48
1117,1156,39,1.738332628,1.912878188,589,569,255,241,'01_37_04.c3d',29,A,B,N,4,neut,20
1100,1192,92,2.180866152,2.289071974,623,626,287,274,'01_37_05.c3d',29,A,B,N,5,neut,3
1068,1091,23,2.39396309,2.384865127,563,524,295,301,'01_37_01.c3d',30,A,B,N,1,neut,39
929,1150,221,1.856508978,1.735841,523,518,226,243,'01_37_02.c3d',30,A,B,N,2,neut,5
980,999,19,1.516056748,1.560594005,619,564,312,297,'01_37_03.c3d',30,A,B,N,3,neut,55
909,1117,208,1.496951502,1.108449893,588,590,52,247,'01_37_04.c3d',30,A,B,N,4,neut,2
1046,1066,20,1.712020946,1.661356858,579,496,167,1,'01_37_05.c3d',30,A,B,N,5,neut,83
1123,1333,210,3.302390718,3.582010163,521,549,324,328,'01_37_01.c3d',31,A,B,N,1,neut,28
1121,1558,437,3.081450058,2.823438015,637,611,357,349,'01_37_02.c3d',31,A,B,N,2,neut,26
1004,1417,413,2.47355024,2.489179426,566,584,302,293,'01_37_03.c3d',31,A,B,N,3,neut,18
1015,1171,156,3.01307827,2.505677385,628,649,386,386,'01_37_04.c3d',31,A,B,N,4,neut,21
1019,1378,359,2.852310006,2.612613981,506,535,274,260,'01_37_05.c3d',31,A,B,N,5,neut,29
1055,1093,38,2.087418916,2.729717698,684,650,425,365,'01_37_01.c3d',32,A,B,N,1,neut,34
950,1222,272,2.035908329,2.362291678,631,635,356,339,'01_37_02.c3d',32,A,B,N,2,neut,4
932,943,11,1.244414503,1.40666764,825,825,318,356,'01_37_03.c3d',32,A,B,N,3,neut,0
1035,1064,29,1.944125843,2.108601557,657,695,319,316,'01_37_04.c3d',32,A,B,N,4,neut,38
821,1406,585,1.556028672,2.058240143,759,774,376,368,'01_37_05.c3d',32,A,B,N,5,neut,15
1002,1065,63,1.61740005,1.890963191,715,667,365,335,'01_37_01.c3d',33,A,B,N,1,neut,48
946,1016,70,1.247217874,1.524960372,716,609,1,329,'01_37_02.c3d',33,A,B,N,2,neut,107
1050,1465,415,1.787351792,2.159969326,775,755,448,435,'01_37_03.c3d',33,A,B,N,3,neut,20
1019,1063,44,1.739813969,2.092463886,634,640,384,374,'01_37_04.c3d',33,A,B,N,4,neut,6
1160,1494,334,1.538728456,1.775385791,640,632,347,344,'01_37_05.c3d',33,A,B,N,5,neut,8
1075,2251,1176,0.907046398,1.400000038,999,833,168,475,'01_37_01.c3d',34,A,B,N,1,neut,166
989,1320,331,2.565771702,2.626080734,562,547,335,334,'01_37_02.c3d',34,A,B,N,2,neut,15
1330,1353,23,1.749033971,2.074727566,745,712,1,394,'01_37_03.c3d',34,A,B,N,3,neut,33
1147,1185,38,1.840771209,2.021279009,644,579,349,1,'01_37_04.c3d',34,A,B,N,4,neut,65
952,1123,171,1.688675185,1.705061681,494,466,251,250,'01_37_05.c3d',34,A,B,N,5,neut,28
940,1080,140,2.516931487,2.445022471,521,520,261,279,'01_37_01.c3d',35,A,B,N,1,neut,1
1210,1299,89,2.899850347,3.025797989,519,522,247,250,'01_37_02.c3d',35,A,B,N,2,neut,3
1106,1214,108,2.666545928,2.300291292,585,552,92,257,'01_37_03.c3d',35,A,B,N,3,neut,33
937,1111,174,2.479605384,2.581878009,497,481,190,179,'01_37_04.c3d',35,A,B,N,4,neut,16
1065,1199,134,2.491774117,2.480446945,563,602,232,262,'01_37_05.c3d',35,A,B,N,5,neut,39
979,1235,256,1.464879528,2.232753686,595,672,1,297,'01_38_01.c3d',1,A,L,N,1,neut,77
568,2425,1857,1.568568705,2.171018201,602,673,146,299,'01_38_02.c3d',1,A,L,N,2,neut,71
680,2405,1725,1.051297465,1.891627071,626,735,329,375,'01_38_03.c3d',1,A,L,N,3,neut,109
529,2122,1593,1.236817998,1.925064791,513,591,1,239,'01_38_04.c3d',1,A,L,N,4,neut,78
936,2725,1789,1.298328028,2.450959594,617,701,366,388,'01_38_05.c3d',1,A,L,N,5,neut,84
998,2145,1147,1.087816312,1.611248201,604,664,1,345,'01_38_01.c3d',2,A,L,N,1,neut,60
1226,1824,598,1.436860881,1.981906298,597,578,1,17,'01_38_02.c3d',2,A,L,N,2,neut,19
949,1227,278,1.536879503,1.837818242,491,540,149,246,'01_38_03.c3d',2,A,L,N,3,neut,49
1079,1776,697,1.292470313,1.454054402,625,647,1,1,'01_38_04.c3d',2,A,L,N,4,neut,22
1200,1376,176,1.487498819,1.780086668,586,585,1,275,'01_38_05.c3d',2,A,L,N,5,neut,1
500,1524,1024,2.256373775,2.518466498,479,527,191,1,'01_38_01.c3d',3,A,L,N,1,neut,48
539,956,417,1.886740691,2.327485227,388,397,174,1,'01_38_02.c3d',3,A,L,N,2,neut,9
464,1415,951,1.683855408,2.209035272,400,414,248,93,'01_38_03.c3d',3,A,L,N,3,neut,14
442,923,481,1.893931105,2.714613115,432,579,254,1,'01_38_04.c3d',3,A,L,N,4,neut,147
461,1031,570,1.432051003,1.83522621,431,514,237,1,'01_38_05.c3d',3,A,L,N,5,neut,83
1042,1514,472,1.698386469,2.308027044,583,673,363,371,'01_38_01.c3d',4,A,L,N,1,neut,90
891,1372,481,1.502475693,1.673700261,470,539,266,251,'01_38_02.c3d',4,A,L,N,2,neut,69
1100,1153,53,1.47384569,2.392717717,553,594,270,295,'01_38_03.c3d',4,A,L,N,3,neut,41
1055,1368,313,1.073957148,2.284678474,578,592,288,313,'01_38_04.c3d',4,A,L,N,4,neut,14
962,1835,873,1.016015242,1.30800238,635,673,1,309,'01_38_05.c3d',4,A,L,N,5,neut,38
817,1047,230,2.512703408,3.15894938,418,475,289,288,'01_38_01.c3d',5,A,L,N,1,neut,57
1018,1054,36,1.952771021,4.01486218,436,466,1,269,'01_38_02.c3d',5,A,L,N,2,neut,30
431,1016,585,2.178264502,3.566017727,418,482,265,268,'01_38_03.c3d',5,A,L,N,3,neut,64
705,1252,547,2.212420871,3.415237182,437,471,80,271,'01_38_04.c3d',5,A,L,N,4,neut,34
833,872,39,1.650893047,3.303414596,483,526,317,309,'01_38_05.c3d',5,A,L,N,5,neut,43
905,1185,280,1.591614456,1.156044572,498,953,297,1,'01_38_01.c3d',6,A,L,N,1,neut,455
548,1099,551,1.381650532,2.13407524,524,565,1,1,'01_38_02.c3d',6,A,L,N,2,neut,41
826,1495,669,1.365548074,2.106004839,522,1047,77,1,'01_38_03.c3d',6,A,L,N,3,neut,525
547,1328,781,1.345043071,1.422093579,504,526,1,282,'01_38_04.c3d',6,A,L,N,4,neut,22
612,1674,1062,1.437011475,1.409277693,593,679,352,1,'01_38_05.c3d',6,A,L,N,5,neut,86
614,1069,455,1.013862432,1.386145174,507,589,134,287,'01_38_01.c3d',7,A,L,N,1,neut,82
768,1315,547,1.167084457,1.483381511,531,597,294,272,'01_38_02.c3d',7,A,L,N,2,neut,66
814,1395,581,1.278607907,1.613797219,554,642,1,3,'01_38_03.c3d',7,A,L,N,3,neut,88
824,1209,385,1.231637707,1.461701517,475,614,27,1,'01_38_04.c3d',7,A,L,N,4,neut,139
949,1729,780,1.409651941,1.999253441,670,766,1,1,'01_38_05.c3d',7,A,L,N,5,neut,96
1179,1306,127,0.87416618,1.987176978,662,782,346,1,'01_38_01.c3d',8,A,L,N,1,neut,120
1340,1778,438,0.980840749,1.93521511,699,812,1,444,'01_38_02.c3d',8,A,L,N,2,neut,113
782,1319,537,1.219009648,1.286505119,253,292,1,1,'01_38_03.c3d',8,A,L,N,3,neut,39
1153,1606,453,0.898668947,1.405851663,529,603,225,242,'01_38_04.c3d',8,A,L,N,4,neut,74
381,946,565,0.599982789,1.093817476,198,519,1,1,'01_38_05.c3d',8,A,L,N,5,neut,321
1712,2706,994,1.106382591,1.577052178,692,701,445,419,'01_38_01.c3d',9,A,L,N,1,neut,9
881,1348,467,0.976335364,3.016486268,664,484,387,303,'01_38_02.c3d',9,A,L,N,2,neut,180
851,1196,345,0.83302817,2.43855447,530,442,1,273,'01_38_03.c3d',9,A,L,N,3,neut,88
867,977,110,1.210912942,2.234329431,404,440,15,124,'01_38_04.c3d',9,A,L,N,4,neut,36
1484,1796,312,0.470958913,1.247457543,831,571,323,250,'01_38_05.c3d',9,A,L,N,5,neut,260
1087,2040,953,1.462549467,4.321290365,810,835,679,557,'01_38_01.c3d',10,A,L,N,1,neut,25
1043,2437,1394,1.373735437,2.530817777,496,548,312,324,'01_38_02.c3d',10,A,L,N,2,neut,52
928,1305,377,1.641606719,2.05514779,396,367,93,31,'01_38_03.c3d',10,A,L,N,3,neut,29
681,775,94,1.755382209,3.13417876,318,406,1,177,'01_38_04.c3d',10,A,L,N,4,neut,88
849,1040,191,1.16327154,2.032995973,390,455,1,1,'01_38_05.c3d',10,A,L,N,5,neut,65
1176,4239,3063,1.131832058,1.559738973,1194,860,245,329,'01_38_01.c3d',11,A,L,N,1,neut,334
1118,1563,445,0.828177016,1.540714851,794,864,389,382,'01_38_02.c3d',11,A,L,N,2,neut,70
878,2677,1799,0.962892886,1.190895864,605,665,327,329,'01_38_03.c3d',11,A,L,N,3,neut,60
1169,1724,555,1.001430375,1.535789034,803,892,76,151,'01_38_04.c3d',11,A,L,N,4,neut,89
1254,1763,509,0.963343024,1.395905642,904,993,569,136,'01_38_05.c3d',11,A,L,N,5,neut,89
505,1515,1010,1.612364062,1.755302276,475,597,302,325,'01_38_01.c3d',12,A,L,N,1,neut,122
911,947,36,1.046199464,2.286403636,475,495,281,299,'01_38_02.c3d',12,A,L,N,2,neut,20
562,1029,467,1.417561133,1.458075783,543,671,315,328,'01_38_03.c3d',12,A,L,N,3,neut,128
536,1556,1020,1.106011046,1.507171853,512,585,261,317,'01_38_04.c3d',12,A,L,N,4,neut,73
512,874,362,1.483208134,2.048318784,476,560,299,306,'01_38_05.c3d',12,A,L,N,5,neut,84
736,1186,450,1.396881474,2.44180142,709,760,1,1,'01_38_01.c3d',13,A,L,N,1,neut,51
486,915,429,1.587080415,2.005916283,454,513,187,1,'01_38_02.c3d',13,A,L,N,2,neut,59
594,1179,585,1.292934139,1.885302505,580,616,307,325,'01_38_03.c3d',13,A,L,N,3,neut,36
693,1863,1170,1.221426567,1.881867398,648,697,411,1,'01_38_04.c3d',13,A,L,N,4,neut,49
786,903,117,1.611134941,2.587882031,402,484,47,129,'01_38_05.c3d',13,A,L,N,5,neut,82
499,860,361,1.725625594,3.743477416,457,557,205,347,'01_38_01.c3d',14,A,L,N,1,neut,100
618,849,231,1.728887672,3.538870846,395,462,134,171,'01_38_02.c3d',14,A,L,N,2,neut,67
635,874,239,1.870044778,3.544388719,437,487,16,211,'01_38_03.c3d',14,A,L,N,3,neut,50
682,960,278,1.544913852,3.392552929,431,497,1,240,'01_38_04.c3d',14,A,L,N,4,neut,66
730,930,200,1.60667007,3.458172058,398,491,1,204,'01_38_05.c3d',14,A,L,N,5,neut,93
463,903,440,1.856085616,2.614384787,440,495,258,214,'01_38_01.c3d',15,A,L,N,1,neut,55
691,1147,456,1.347408797,2.756465319,445,508,1,143,'01_38_02.c3d',15,A,L,N,2,neut,63
524,928,404,1.231228912,2.078023254,482,569,133,264,'01_38_03.c3d',15,A,L,N,3,neut,87
403,927,524,1.064425406,1.779060229,381,512,1,1,'01_38_04.c3d',15,A,L,N,4,neut,131
260,1015,755,1.24031498,1.37082463,234,237,1,1,'01_38_05.c3d',15,A,L,N,5,neut,3
569,780,211,1.273933234,2.626158333,491,500,290,282,'01_38_01.c3d',16,A,L,N,1,neut,9
535,1383,848,1.179827005,2.590593484,455,490,76,80,'01_38_02.c3d',16,A,L,N,2,neut,35
514,979,465,1.342820684,2.505881119,452,545,76,232,'01_38_03.c3d',16,A,L,N,3,neut,93
509,890,381,1.274697306,2.560075042,442,501,1,60,'01_38_04.c3d',16,A,L,N,4,neut,59
550,1289,739,1.449762085,2.774913006,560,623,268,269,'01_38_05.c3d',16,A,L,N,5,neut,63
589,801,212,1.697986674,2.99112106,396,476,256,269,'01_38_01.c3d',17,A,L,N,1,neut,80
1074,1159,85,2.262171517,3.624930467,455,523,283,312,'01_38_02.c3d',17,A,L,N,2,neut,68
638,1007,369,2.115288605,2.801009488,404,454,266,280,'01_38_03.c3d',17,A,L,N,3,neut,50
668,756,88,2.390281263,3.280426971,400,454,256,265,'01_38_04.c3d',17,A,L,N,4,neut,54
57,1080,1023,1.826622408,1.792362636,25,41,1,1,'01_38_05.c3d',17,A,L,N,5,neut,16
417,1571,1154,2.293129078,3.648134788,448,506,1,45,'01_38_01.c3d',18,A,L,N,1,neut,58
461,1113,652,2.179893577,3.108091122,459,514,1,1,'01_38_02.c3d',18,A,L,N,2,neut,55
970,2045,1075,1.847803185,2.799742152,510,547,1,1,'01_38_03.c3d',18,A,L,N,3,neut,37
516,1529,1013,1.313877885,3.186221537,541,572,1,300,'01_38_04.c3d',18,A,L,N,4,neut,31
558,1388,830,1.29569528,2.470200201,543,658,81,350,'01_38_05.c3d',18,A,L,N,5,neut,115
701,1176,475,1.232619409,2.189551509,543,585,309,353,'01_38_01.c3d',19,A,L,N,1,neut,42
602,1023,421,1.321090388,2.255117416,596,649,198,374,'01_38_02.c3d',19,A,L,N,2,neut,53
506,1358,852,1.623610909,2.714618466,516,517,252,216,'01_38_03.c3d',19,A,L,N,3,neut,1
593,2254,1661,1.104051578,1.78381404,555,563,289,318,'01_38_04.c3d',19,A,L,N,4,neut,8
586,1028,442,1.002745673,1.701900111,460,572,273,1,'01_38_05.c3d',19,A,L,N,5,neut,112
673,1100,427,1.789408497,2.665530907,636,673,1,426,'01_38_01.c3d',20,A,L,N,1,neut,37
790,1058,268,1.546428374,2.423272609,486,551,322,316,'01_38_02.c3d',20,A,L,N,2,neut,65
566,2136,1570,1.118734387,1.669298438,508,518,285,264,'01_38_03.c3d',20,A,L,N,3,neut,10
689,1253,564,0.900862869,2.260805561,510,582,293,296,'01_38_04.c3d',20,A,L,N,4,neut,72
613,1275,662,1.41351868,2.01922574,559,598,354,346,'01_38_05.c3d',20,A,L,N,5,neut,39
618,991,373,0.999979159,1.547003152,570,678,302,336,'01_38_01.c3d',21,A,L,N,1,neut,108
1038,1587,549,1.129703933,1.983915127,670,725,376,358,'01_38_02.c3d',21,A,L,N,2,neut,55
738,1321,583,1.706413271,1.605648649,1,33,1,1,'01_38_03.c3d',21,A,L,N,3,neut,32
532,1086,554,1.249932488,1.930058298,480,562,258,269,'01_38_04.c3d',21,A,L,N,4,neut,82
811,1185,374,1.343415282,1.529080766,522,643,1,121,'01_38_05.c3d',21,A,L,N,5,neut,121
596,1317,721,1.363618475,1.545808811,550,785,322,310,'01_38_01.c3d',22,A,L,N,1,neut,235
520,1254,734,1.476567511,2.01226928,483,663,217,95,'01_38_02.c3d',22,A,L,N,2,neut,180
683,1336,653,1.209788602,1.925433329,635,745,375,427,'01_38_03.c3d',22,A,L,N,3,neut,110
668,1338,670,1.163896496,1.375779007,614,948,360,401,'01_38_04.c3d',22,A,L,N,4,neut,334
691,1479,788,0.931612585,1.273779646,618,860,313,338,'01_38_05.c3d',22,A,L,N,5,neut,242
887,3223,2336,1.16591367,1.428264244,589,712,247,291,'01_38_01.c3d',23,A,L,N,1,neut,123
1293,2138,845,0.758190544,1.137196721,774,820,116,346,'01_38_02.c3d',23,A,L,N,2,neut,46
1047,2258,1211,0.963349637,0.99599157,610,763,296,326,'01_38_03.c3d',23,A,L,N,3,neut,153
1251,2176,925,0.698848077,0.986427901,733,860,297,334,'01_38_04.c3d',23,A,L,N,4,neut,127
1044,2534,1490,0.871691555,0.565212411,684,759,289,274,'01_38_05.c3d',23,A,L,N,5,neut,75
659,1202,543,1.6264499,2.14283222,442,527,235,277,'01_38_01.c3d',24,A,L,N,1,neut,85
803,1207,404,1.749569549,2.638736512,535,642,206,360,'01_38_02.c3d',24,A,L,N,2,neut,107
809,1038,229,1.410908097,2.56338088,452,546,246,1,'01_38_03.c3d',24,A,L,N,3,neut,94
645,904,259,1.452842947,2.39622945,435,492,241,225,'01_38_04.c3d',24,A,L,N,4,neut,57
798,1318,520,1.335067617,2.283905739,459,566,259,195,'01_38_05.c3d',24,A,L,N,5,neut,107
870,1120,250,0.916215642,1.7299766,487,522,285,295,'01_38_01.c3d',25,A,L,N,1,neut,35
523,975,452,1.248115255,1.690368825,485,547,1,265,'01_38_02.c3d',25,A,L,N,2,neut,62
493,2709,2216,1.304238378,1.54964314,426,574,233,260,'01_38_03.c3d',25,A,L,N,3,neut,148
506,952,446,1.404121125,2.099129544,438,499,273,292,'01_38_04.c3d',25,A,L,N,4,neut,61
706,1898,1192,1.258256839,1.590377184,399,455,228,109,'01_38_05.c3d',25,A,L,N,5,neut,56
587,1501,914,0.946366153,1.605499673,489,618,265,308,'01_38_01.c3d',26,A,L,N,1,neut,129
592,1551,959,0.977899223,1.272318825,562,704,292,292,'01_38_02.c3d',26,A,L,N,2,neut,142
767,2412,1645,0.782879458,1.369540443,656,762,126,402,'01_38_03.c3d',26,A,L,N,3,neut,106
745,2307,1562,1.30698682,1.618114865,793,774,481,276,'01_38_04.c3d',26,A,L,N,4,neut,19
551,1589,1038,0.973405197,1.480427374,496,667,256,263,'01_38_05.c3d',26,A,L,N,5,neut,171
718,1188,470,1.137356987,1.883531239,698,731,349,330,'01_38_01.c3d',27,A,L,N,1,neut,33
948,1178,230,1.178243738,2.282583165,564,674,308,307,'01_38_02.c3d',27,A,L,N,2,neut,110
685,1254,569,1.189125999,1.863968567,609,715,346,340,'01_38_03.c3d',27,A,L,N,3,neut,106
718,1370,652,1.318639248,1.891391129,682,756,1,428,'01_38_04.c3d',27,A,L,N,4,neut,74
714,1429,715,1.197699445,1.700194137,669,731,375,373,'01_38_05.c3d',27,A,L,N,5,neut,62
2012,2338,326,0.795693575,1.256982061,1847,2023,320,769,'01_38_01.c3d',28,A,L,N,1,neut,176
575,1076,501,1.452165202,1.853844803,574,706,299,1,'01_38_02.c3d',28,A,L,N,2,neut,132
834,894,60,0.930688164,1.556757125,516,671,256,1,'01_38_03.c3d',28,A,L,N,3,neut,155
1013,1060,47,1.144203403,1.251156116,640,708,311,261,'01_38_04.c3d',28,A,L,N,4,neut,68
633,1658,1025,1.050168821,1.191843928,542,675,1,318,'01_38_05.c3d',28,A,L,N,5,neut,133
647,1101,454,1.319901267,2.41872373,612,645,398,407,'01_38_01.c3d',29,A,L,N,1,neut,33
653,1288,635,1.433312791,2.334589856,627,783,386,421,'01_38_02.c3d',29,A,L,N,2,neut,156
458,1062,604,1.508771315,2.359977872,467,548,104,277,'01_38_03.c3d',29,A,L,N,3,neut,81
393,940,547,1.64562052,2.169215158,401,500,134,101,'01_38_04.c3d',29,A,L,N,4,neut,99
878,1265,387,1.135219857,1.613973681,454,538,81,225,'01_38_05.c3d',29,A,L,N,5,neut,84
556,947,391,1.046339915,1.989745629,502,613,27,323,'01_38_01.c3d',30,A,L,N,1,neut,111
620,1006,386,0.880116348,1.559201085,486,700,249,289,'01_38_02.c3d',30,A,L,N,2,neut,214
561,1081,520,0.901007961,1.302599683,429,541,1,198,'01_38_03.c3d',30,A,L,N,3,neut,112
616,1239,623,0.870886982,1.43785592,478,650,59,8,'01_38_04.c3d',30,A,L,N,4,neut,172
733,992,259,0.968013367,1.245527164,461,558,72,275,'01_38_05.c3d',30,A,L,N,5,neut,97
822,1208,386,2.160465785,2.950456424,814,855,584,603,'01_38_01.c3d',31,A,L,N,1,neut,41
566,930,364,1.448495122,2.647804888,510,544,292,292,'01_38_02.c3d',31,A,L,N,2,neut,34
587,1003,416,1.57814852,2.587992024,543,546,330,330,'01_38_03.c3d',31,A,L,N,3,neut,3
1006,1332,326,1.429995005,2.01941989,688,747,393,388,'01_38_04.c3d',31,A,L,N,4,neut,59
1050,1095,45,1.539429824,2.447046271,537,624,324,314,'01_38_05.c3d',31,A,L,N,5,neut,87
715,913,198,1.11163011,2.233181369,592,614,1,1,'01_38_01.c3d',32,A,L,N,1,neut,22
902,1188,286,1.332958782,2.959518534,534,569,305,295,'01_38_02.c3d',32,A,L,N,2,neut,35
894,1130,236,1.362221596,2.548292386,527,585,278,1,'01_38_03.c3d',32,A,L,N,3,neut,58
689,1185,496,1.080688716,2.569762119,661,790,374,394,'01_38_04.c3d',32,A,L,N,4,neut,129
622,1470,848,0.933586456,1.708080702,516,606,39,301,'01_38_05.c3d',32,A,L,N,5,neut,90
864,1201,337,1.092188633,1.946292936,765,725,1,412,'01_38_01.c3d',33,A,L,N,1,neut,40
760,1224,464,1.231588861,1.864793894,715,754,430,10,'01_38_02.c3d',33,A,L,N,2,neut,39
800,1163,363,1.050554918,1.461828221,621,702,359,341,'01_38_03.c3d',33,A,L,N,3,neut,81
669,1363,694,1.172527625,2.065553502,642,616,356,322,'01_38_04.c3d',33,A,L,N,4,neut,26
1025,1266,241,0.995228566,2.120742707,742,744,447,444,'01_38_05.c3d',33,A,L,N,5,neut,2
1237,2053,816,0.802953329,1.945357065,966,922,1,695,'01_38_01.c3d',34,A,L,N,1,neut,44
873,1391,518,1.42937929,2.096204086,477,464,244,233,'01_38_02.c3d',34,A,L,N,2,neut,13
483,1099,616,1.443376723,2.28081477,472,478,1,244,'01_38_03.c3d',34,A,L,N,3,neut,6
943,957,14,1.261691239,2.081937145,546,562,299,125,'01_38_04.c3d',34,A,L,N,4,neut,16
848,1037,189,1.155610684,1.949273062,484,518,280,296,'01_38_05.c3d',34,A,L,N,5,neut,34
412,833,421,1.677927301,2.258554725,413,470,92,105,'01_38_01.c3d',35,A,L,N,1,neut,57
520,1257,737,1.5833598,2.623190094,502,575,271,271,'01_38_02.c3d',35,A,L,N,2,neut,73
963,1537,574,1.684495505,2.344396622,446,433,164,180,'01_38_03.c3d',35,A,L,N,3,neut,13
507,1191,684,1.585540689,2.645976291,502,592,241,262,'01_38_04.c3d',35,A,L,N,4,neut,90
539,1158,619,1.542316402,2.102712297,516,592,255,275,'01_38_05.c3d',35,A,L,N,5,neut,76
1537,1845,308,1.257827484,1.489763323,742,728,410,399,'01_39_01.c3d',1,A,R,N,1,neut,14
1075,1898,823,1.797561882,1.658929623,633,626,344,314,'01_39_02.c3d',1,A,R,N,2,neut,7
1185,1210,25,1.08339987,1.422391938,288,347,1,1,'01_39_03.c3d',1,A,R,N,3,neut,59
508,1271,763,1.748439619,1.641060609,649,560,129,194,'01_39_04.c3d',1,A,R,N,4,neut,89
1004,1140,136,1.660733714,1.321991403,639,550,98,1,'01_39_05.c3d',1,A,R,N,5,neut,89
961,1647,686,1.481194961,1.517932071,649,608,316,1,'01_39_01.c3d',2,A,R,N,1,neut,41
975,1438,463,1.525255275,1.340183428,740,691,419,1,'01_39_02.c3d',2,A,R,N,2,neut,49
1002,1166,164,2.372114396,1.55698352,722,640,431,1,'01_39_03.c3d',2,A,R,N,3,neut,82
875,1062,187,1.488938637,1.195849468,597,543,249,1,'01_39_04.c3d',2,A,R,N,4,neut,54
1269,1550,281,1.992936934,1.805095627,603,487,263,1,'01_39_05.c3d',2,A,R,N,5,neut,116
530,1521,991,2.316184681,2.028451167,523,487,323,345,'01_39_01.c3d',3,A,R,N,1,neut,36
692,995,303,2.726132582,2.295175218,441,406,258,57,'01_39_02.c3d',3,A,R,N,2,neut,35
840,1275,435,1.82180116,1.44664474,502,485,248,1,'01_39_03.c3d',3,A,R,N,3,neut,17
790,1056,266,1.924022269,1.389628982,508,469,261,126,'01_39_04.c3d',3,A,R,N,4,neut,39
507,1033,526,1.904109887,1.676818698,534,486,295,64,'01_39_05.c3d',3,A,R,N,5,neut,48
844,915,71,2.743132366,1.554508485,542,468,301,1,'01_39_01.c3d',4,A,R,N,1,neut,74
1070,1321,251,2.211427788,1.86273539,618,529,295,290,'01_39_02.c3d',4,A,R,N,2,neut,89
1059,1434,375,1.941959523,1.274291777,598,572,1,293,'01_39_03.c3d',4,A,R,N,3,neut,26
555,974,419,1.838917826,1.379683159,579,531,294,81,'01_39_04.c3d',4,A,R,N,4,neut,48
1097,1124,27,2.094023069,1.283178096,592,540,297,1,'01_39_05.c3d',4,A,R,N,5,neut,52
549,1785,1236,2.606651304,1.691242965,522,481,336,332,'01_39_01.c3d',5,A,R,N,1,neut,41
502,786,284,3.425348171,1.99003585,461,465,300,295,'01_39_02.c3d',5,A,R,N,2,neut,4
349,917,568,2.9327547,2.214275092,388,350,185,196,'01_39_03.c3d',5,A,R,N,3,neut,38
425,1178,753,3.589216273,2.651328325,459,427,267,268,'01_39_04.c3d',5,A,R,N,4,neut,32
459,1222,763,2.202998994,1.747506025,433,447,251,103,'01_39_05.c3d',5,A,R,N,5,neut,14
1936,2209,273,1.111541821,0.837374955,1568,1529,40,33,'01_39_01.c3d',6,A,R,N,1,neut,39
1084,1567,483,0.80334296,1.573579926,426,571,1,77,'01_39_02.c3d',6,A,R,N,2,neut,145
933,1617,684,1.683966882,1.26916868,1160,589,749,1,'01_39_03.c3d',6,A,R,N,3,neut,571
918,1402,484,1.426331353,1.743186459,1090,563,1,1,'01_39_04.c3d',6,A,R,N,4,neut,527
839,1451,612,2.134572426,1.475373395,1155,559,296,285,'01_39_05.c3d',6,A,R,N,5,neut,596
940,953,13,2.125177335,1.013189536,561,518,299,225,'01_39_01.c3d',7,A,R,N,1,neut,43
1114,1149,35,1.378232619,1.089257756,543,499,285,53,'01_39_02.c3d',7,A,R,N,2,neut,44
795,939,144,1.296748509,1.269605282,477,380,129,44,'01_39_03.c3d',7,A,R,N,3,neut,97
1042,1488,446,1.593044695,0.910459755,576,444,267,1,'01_39_04.c3d',7,A,R,N,4,neut,132
986,1290,304,1.39071946,1.171038296,554,405,1,1,'01_39_05.c3d',7,A,R,N,5,neut,149
1917,2130,213,1.924275665,1.504544177,579,524,285,268,'01_39_01.c3d',8,A,R,N,1,neut,55
577,1446,869,1.795022989,1.344138041,626,581,304,283,'01_39_02.c3d',8,A,R,N,2,neut,45
1164,2144,980,1.261649513,0.920868856,1030,1063,775,1,'01_39_03.c3d',8,A,R,N,3,neut,33
1041,1906,865,1.147577694,0.821401387,746,685,383,374,'01_39_04.c3d',8,A,R,N,4,neut,61
1256,1394,138,1.466002224,1.100319584,575,647,291,291,'01_39_05.c3d',8,A,R,N,5,neut,72
809,1498,689,1.477346186,1.984401135,612,417,324,259,'01_39_01.c3d',9,A,R,N,1,neut,195
899,1609,710,1.586435811,1.187099876,507,445,279,257,'01_39_02.c3d',9,A,R,N,2,neut,62
809,1250,441,1.386626134,1.085974074,496,434,267,255,'01_39_03.c3d',9,A,R,N,3,neut,62
731,1319,588,1.562438754,1.177890027,509,435,45,268,'01_39_04.c3d',9,A,R,N,4,neut,74
869,1903,1034,0.988869463,0.876729266,1548,562,1,322,'01_39_05.c3d',9,A,R,N,5,neut,986
2726,2732,6,3.223747199,1.733103677,808,816,603,661,'01_39_01.c3d',10,A,R,N,1,neut,8
739,1552,813,2.639873073,2.248253299,485,457,273,293,'01_39_02.c3d',10,A,R,N,2,neut,28
524,1228,704,2.507797249,1.622926594,515,502,276,275,'01_39_03.c3d',10,A,R,N,3,neut,13
1037,1312,275,1.619638354,1.029710373,461,307,15,10,'01_39_04.c3d',10,A,R,N,4,neut,154
805,1253,448,1.889282627,0.828826842,509,474,17,1,'01_39_05.c3d',10,A,R,N,5,neut,35
1090,2151,1061,0.876498904,0.779591477,788,729,1,1,'01_39_01.c3d',11,A,R,N,1,neut,59
887,1707,820,1.008072621,0.620171637,726,664,370,99,'01_39_02.c3d',11,A,R,N,2,neut,62
1050,1545,495,0.987483465,0.896829488,713,680,226,93,'01_39_03.c3d',11,A,R,N,3,neut,33
1101,1907,806,0.770471104,0.741767642,750,722,366,1,'01_39_04.c3d',11,A,R,N,4,neut,28
1149,2483,1334,0.596618749,0.68746127,877,769,498,426,'01_39_05.c3d',11,A,R,N,5,neut,108
568,1138,570,1.836865343,1.076771713,465,486,295,278,'01_39_01.c3d',12,A,R,N,1,neut,21
533,1331,798,1.758541808,1.330681167,525,468,303,1,'01_39_02.c3d',12,A,R,N,2,neut,57
586,1076,490,1.692423014,1.186660889,562,517,301,310,'01_39_03.c3d',12,A,R,N,3,neut,45
597,1264,667,1.799008477,1.183958483,585,537,92,313,'01_39_04.c3d',12,A,R,N,4,neut,48
482,1194,712,2.082449426,1.448800225,437,436,255,260,'01_39_05.c3d',12,A,R,N,5,neut,1
539,1557,1018,2.711318977,1.768787,520,515,287,285,'01_39_01.c3d',13,A,R,N,1,neut,5
520,956,436,2.256332818,1.733316623,528,513,253,1,'01_39_02.c3d',13,A,R,N,2,neut,15
552,961,409,2.005942082,1.417557162,578,494,296,1,'01_39_03.c3d',13,A,R,N,3,neut,84
556,1551,995,2.275923987,1.465503205,578,520,314,190,'01_39_04.c3d',13,A,R,N,4,neut,58
587,1695,1108,2.304682803,1.574781705,625,573,351,1,'01_39_05.c3d',13,A,R,N,5,neut,52
1001,2052,1051,2.719460728,2.008038366,976,989,10,21,'01_39_01.c3d',14,A,R,N,1,neut,13
479,938,459,2.80010078,2.146328742,432,471,274,82,'01_39_02.c3d',14,A,R,N,2,neut,39
761,1025,264,2.499219742,1.999646942,477,487,1,286,'01_39_03.c3d',14,A,R,N,3,neut,10
525,1319,794,1.784482964,1.491848508,461,471,1,1,'01_39_04.c3d',14,A,R,N,4,neut,10
1016,1496,480,2.485883378,1.769556795,450,444,252,261,'01_39_05.c3d',14,A,R,N,5,neut,6
642,1501,859,2.221069455,1.295730977,603,543,308,132,'01_39_01.c3d',15,A,R,N,1,neut,60
630,933,303,2.102283822,1.11509606,560,495,282,307,'01_39_02.c3d',15,A,R,N,2,neut,65
471,976,505,1.933843632,1.375666798,470,429,51,76,'01_39_03.c3d',15,A,R,N,3,neut,41
360,919,559,1.803778636,1.84466436,473,371,97,70,'01_39_04.c3d',15,A,R,N,4,neut,102
544,960,416,1.962160363,1.680856068,514,527,272,285,'01_39_05.c3d',15,A,R,N,5,neut,13
610,1338,728,1.579608047,1.408244009,587,543,328,337,'01_39_01.c3d',16,A,R,N,1,neut,44
643,1230,587,2.14761372,1.446505766,644,602,370,17,'01_39_02.c3d',16,A,R,N,2,neut,42
790,1466,676,2.027784245,1.606625465,480,363,1,107,'01_39_03.c3d',16,A,R,N,3,neut,117
593,1055,462,1.539186048,0.557683426,615,398,117,1,'01_39_04.c3d',16,A,R,N,4,neut,217
535,981,446,2.135695638,1.288436678,609,489,164,164,'01_39_05.c3d',16,A,R,N,5,neut,120
710,1041,331,3.628001814,2.492482764,441,389,248,2,'01_39_01.c3d',17,A,R,N,1,neut,52
685,1181,496,4.109395421,4.080516251,425,417,300,302,'01_39_02.c3d',17,A,R,N,2,neut,8
826,1854,1028,2.511369104,2.778772351,442,415,282,280,'01_39_03.c3d',17,A,R,N,3,neut,27
814,841,27,2.586685211,2.238739253,471,381,235,241,'01_39_04.c3d',17,A,R,N,4,neut,90
708,762,54,3.274035972,2.027007126,419,408,260,262,'01_39_05.c3d',17,A,R,N,5,neut,11
859,1442,583,2.752252885,2.17300163,515,494,64,212,'01_39_01.c3d',18,A,R,N,1,neut,21
897,1390,493,2.725077919,2.55340668,567,563,1,359,'01_39_02.c3d',18,A,R,N,2,neut,4
1139,1601,462,2.543078906,2.039710982,505,542,311,1,'01_39_03.c3d',18,A,R,N,3,neut,37
549,1309,760,3.352244608,2.142063085,584,597,81,16,'01_39_04.c3d',18,A,R,N,4,neut,13
602,1711,1109,1.952532471,1.465244001,674,608,1,1,'01_39_05.c3d',18,A,R,N,5,neut,66
723,1171,448,1.06232215,0.851844024,586,506,301,73,'01_39_01.c3d',19,A,R,N,1,neut,80
531,937,406,1.803689146,1.349903984,555,506,16,272,'01_39_02.c3d',19,A,R,N,2,neut,49
762,960,198,2.270708756,1.744099624,583,505,316,69,'01_39_03.c3d',19,A,R,N,3,neut,78
699,861,162,2.262036683,1.649451557,516,459,292,240,'01_39_04.c3d',19,A,R,N,4,neut,57
577,1270,693,1.512036479,0.928320344,583,476,1,127,'01_39_05.c3d',19,A,R,N,5,neut,107
813,1268,455,2.172666343,1.590323554,566,495,323,1,'01_39_01.c3d',20,A,R,N,1,neut,71
605,1029,424,2.295642987,1.558161864,595,572,353,1,'01_39_02.c3d',20,A,R,N,2,neut,23
799,1238,439,2.221037181,1.60924664,478,480,260,157,'01_39_03.c3d',20,A,R,N,3,neut,2
885,1341,456,2.045666686,1.393954315,592,511,332,310,'01_39_04.c3d',20,A,R,N,4,neut,81
863,1299,436,1.803560306,1.316004492,606,522,316,200,'01_39_05.c3d',20,A,R,N,5,neut,84
903,1244,341,2.02196524,1.32410835,604,507,312,282,'01_39_01.c3d',21,A,R,N,1,neut,97
999,1194,195,1.590574265,1.280557792,561,525,1,1,'01_39_02.c3d',21,A,R,N,2,neut,36
899,1057,158,1.887523411,1.101729849,528,516,259,264,'01_39_03.c3d',21,A,R,N,3,neut,12
885,1103,218,1.362066563,1.16402614,561,516,289,277,'01_39_04.c3d',21,A,R,N,4,neut,45
944,1234,290,1.248032554,0.925158691,591,553,253,1,'01_39_05.c3d',21,A,R,N,5,neut,38
829,1552,723,0.988063948,1.289306007,638,791,437,1,'01_39_01.c3d',22,A,R,N,1,neut,153
686,1455,769,0.724128933,1.339226102,1327,622,82,348,'01_39_02.c3d',22,A,R,N,2,neut,705
711,1417,706,1.200688714,1.449888358,774,655,361,400,'01_39_03.c3d',22,A,R,N,3,neut,119
681,1158,477,1.433222528,1.409524463,766,646,363,365,'01_39_04.c3d',22,A,R,N,4,neut,120
665,955,290,1.158065059,1.237797772,724,598,280,303,'01_39_05.c3d',22,A,R,N,5,neut,126
1143,1784,641,0.661242623,1.230969264,1649,683,289,316,'01_39_01.c3d',23,A,R,N,1,neut,966
1120,1791,671,0.86112246,0.85787082,650,656,1,314,'01_39_02.c3d',23,A,R,N,2,neut,6
1403,1659,256,1.188304363,0.651856775,658,668,321,259,'01_39_03.c3d',23,A,R,N,3,neut,10
1326,1689,363,1.076884829,1.039846731,567,607,266,267,'01_39_04.c3d',23,A,R,N,4,neut,40
1831,1889,58,0.964723349,0.649494018,807,895,379,334,'01_39_05.c3d',23,A,R,N,5,neut,88
916,1149,233,2.121289468,1.340466538,520,490,274,1,'01_39_01.c3d',24,A,R,N,1,neut,30
806,1188,382,2.592561829,1.610854567,553,527,365,1,'01_39_02.c3d',24,A,R,N,2,neut,26
714,836,122,1.827055666,1.206277449,528,472,260,1,'01_39_03.c3d',24,A,R,N,3,neut,56
1010,1050,40,2.27814646,1.34660539,538,467,240,84,'01_39_04.c3d',24,A,R,N,4,neut,71
872,1326,454,1.973672134,1.747204437,526,455,221,218,'01_39_05.c3d',24,A,R,N,5,neut,71
909,1291,382,1.765585037,1.053469073,617,618,1,1,'01_39_01.c3d',25,A,R,N,1,neut,1
785,1712,927,1.637949854,0.974859994,721,705,409,365,'01_39_02.c3d',25,A,R,N,2,neut,16
821,1477,656,1.478223209,0.774688944,773,593,331,1,'01_39_03.c3d',25,A,R,N,3,neut,180
560,1394,834,1.238821912,0.95504801,575,471,259,248,'01_39_04.c3d',25,A,R,N,4,neut,104
529,1096,567,1.193563425,0.949515737,593,458,213,154,'01_39_05.c3d',25,A,R,N,5,neut,135
1807,2341,534,2.30699556,0.936664815,630,555,335,297,'01_39_01.c3d',26,A,R,N,1,neut,75
1994,2084,90,1.682408092,1.018405502,641,570,349,311,'01_39_02.c3d',26,A,R,N,2,neut,71
910,1962,1052,1.319932607,0.641420995,681,532,351,1,'01_39_03.c3d',26,A,R,N,3,neut,149
1184,1623,439,1.963627081,1.376500366,768,637,82,382,'01_39_04.c3d',26,A,R,N,4,neut,131
1055,2351,1296,1.901264483,0.688600375,591,563,265,257,'01_39_05.c3d',26,A,R,N,5,neut,28
780,1234,454,1.329255993,1.069313492,705,646,354,391,'01_39_01.c3d',27,A,R,N,1,neut,59
879,1043,164,2.035358486,1.271234755,821,817,1,517,'01_39_02.c3d',27,A,R,N,2,neut,4
1080,1244,164,1.353428732,0.776823985,779,834,1,461,'01_39_03.c3d',27,A,R,N,3,neut,55
815,1023,208,1.546069683,0.933528172,816,764,438,387,'01_39_04.c3d',27,A,R,N,4,neut,52
890,1198,308,1.193975721,0.741491651,666,565,325,1,'01_39_05.c3d',27,A,R,N,5,neut,101
602,2231,1629,1.611349602,1.335788802,691,586,319,1,'01_39_01.c3d',28,A,R,N,1,neut,105
1532,3065,1533,1.611389803,1.197905331,1310,1186,941,1,'01_39_02.c3d',28,A,R,N,2,neut,124
733,1209,476,1.3155148,0.937515959,637,614,330,333,'01_39_03.c3d',28,A,R,N,3,neut,23
1173,1547,374,1.666200089,1.389835218,662,634,312,306,'01_39_04.c3d',28,A,R,N,4,neut,28
595,1220,625,1.643630735,1.194021591,606,571,287,260,'01_39_05.c3d',28,A,R,N,5,neut,35
731,1773,1042,2.279771236,1.973237264,594,524,352,349,'01_39_01.c3d',29,A,R,N,1,neut,70
1040,1445,405,2.636643293,2.060055773,660,623,402,1,'01_39_02.c3d',29,A,R,N,2,neut,37
1030,1128,98,2.11792647,1.578315927,619,566,347,1,'01_39_03.c3d',29,A,R,N,3,neut,53
535,1221,686,2.477532929,1.322102121,547,531,281,1,'01_39_04.c3d',29,A,R,N,4,neut,16
936,942,6,1.784105323,1.392485649,567,544,283,14,'01_39_05.c3d',29,A,R,N,5,neut,23
871,1259,388,2.344619989,2.003661033,625,593,386,405,'01_39_01.c3d',30,A,R,N,1,neut,32
809,1063,254,1.84478484,1.627099411,580,492,296,1,'01_39_02.c3d',30,A,R,N,2,neut,88
497,688,191,1.495945747,1.078184784,507,409,1,182,'01_39_03.c3d',30,A,R,N,3,neut,98
385,1093,708,0.833242836,0.721280194,468,224,1,13,'01_39_04.c3d',30,A,R,N,4,neut,244
699,2116,1417,1.075813783,0.71083229,650,562,52,158,'01_39_05.c3d',30,A,R,N,5,neut,88
512,1040,528,2.980611042,1.923267535,534,474,302,285,'01_39_01.c3d',31,A,R,N,1,neut,60
569,1451,882,2.600279631,1.968438502,605,563,341,333,'01_39_02.c3d',31,A,R,N,2,neut,42
757,2036,1279,2.774967426,1.78326477,773,728,508,519,'01_39_03.c3d',31,A,R,N,3,neut,45
998,1218,220,2.797954155,1.686914957,550,496,290,270,'01_39_04.c3d',31,A,R,N,4,neut,54
452,951,499,3.23981715,1.834709408,502,405,231,178,'01_39_05.c3d',31,A,R,N,5,neut,97
563,950,387,1.946828671,1.395493428,586,544,331,314,'01_39_01.c3d',32,A,R,N,1,neut,42
878,1164,286,1.993412621,1.081841426,603,547,324,42,'01_39_02.c3d',32,A,R,N,2,neut,56
600,1279,679,1.859590745,1.077104465,624,557,327,280,'01_39_03.c3d',32,A,R,N,3,neut,67
665,1772,1107,1.558801623,1.023933098,628,627,343,299,'01_39_04.c3d',32,A,R,N,4,neut,1
620,1234,614,1.603589705,1.031112272,638,602,296,275,'01_39_05.c3d',32,A,R,N,5,neut,36
1535,1694,159,1.432796979,1.13643105,1109,925,535,1,'01_39_01.c3d',33,A,R,N,1,neut,184
1091,1325,234,1.361452217,1.452370099,788,708,457,427,'01_39_02.c3d',33,A,R,N,2,neut,80
941,957,16,2.413265116,1.521599826,600,520,318,251,'01_39_03.c3d',33,A,R,N,3,neut,80
1161,1184,23,1.627619437,1.300785678,640,567,305,290,'01_39_04.c3d',33,A,R,N,4,neut,73
636,1048,412,1.87679317,1.264709025,635,607,335,270,'01_39_05.c3d',33,A,R,N,5,neut,28
825,1319,494,1.764878908,1.613207532,678,597,448,436,'01_39_01.c3d',34,A,R,N,1,neut,81
710,1134,424,2.317620109,0.888794291,728,701,415,1,'01_39_02.c3d',34,A,R,N,2,neut,27
551,1150,599,1.835651228,1.143611509,594,459,293,1,'01_39_03.c3d',34,A,R,N,3,neut,135
530,862,332,1.217610389,0.881317195,574,408,261,213,'01_39_04.c3d',34,A,R,N,4,neut,166
525,827,302,1.824894566,0.921766683,565,405,243,212,'01_39_05.c3d',34,A,R,N,5,neut,160
698,1065,367,2.824591672,1.657505201,481,451,244,63,'01_39_01.c3d',35,A,R,N,1,neut,30
542,1388,846,2.538847876,1.855346468,568,508,308,312,'01_39_02.c3d',35,A,R,N,2,neut,60
641,899,258,1.837196179,1.462237979,253,307,1,1,'01_39_03.c3d',35,A,R,N,3,neut,54
422,1238,816,2.48035137,1.923809327,477,438,141,168,'01_39_04.c3d',35,A,R,N,4,neut,39
871,1060,189,2.318365,1.290559632,560,464,30,63,'01_39_05.c3d',35,A,R,N,5,neut,96